井原 勇一	ihara_yuuichi@example.com
柳田 佳乃	yanagida_yoshino@example.com
田端 ひとみ	tabata_hitomi@example.com
吉永 光洋	yoshinaga_mitsuhiro@example.com
ト字 勤	toji_tsutomu@example.com
前原 法子	maehara_noriko@example.com
吉田 沙耶	yoshida_saya@example.com
並木 大五郎	namiki_daigorou@example.com
松居 ひとり	matsui_hitori@example.com
滝 有起哉	taki_yukiya@example.com
村木 まさみ	muraki_masami@example.com
畠山 ケンイチ	hatayama_kenichi@example.com
長谷川 光	hasegawa_hikaru@example.com
大西 はるみ	oonishi_harumi@example.com
大山 雄太	ooyama_yuuta@example.com
河田 隆博	kawata_takahiro@example.com
戸塚 美帆	toduka_miho@example.com
久保 あい	kubo_ai@example.com
大津 貴嶺	ootsu_takane@example.com
西野 輝信	nishino_akinobu@example.com
畠中 勝久	hatanaka_katsuhisa@example.com
塚原 美嘉	tsukahara_mika@example.com
菅原 有起哉	sugawara_yukiya@example.com
大和 美和子	yamato_miwako@example.com
小高 美佐子	kodaka_misako@example.com
中里 さやか	nakazato_sayaka@example.com
野原 美幸	nohara_miyuki@example.com
芦田 基祐	ashida_kisuke@example.com
田所 めぐみ	tadokoro_megumi@example.com
戎 芽以	ebisu_mei@example.com
小西 コウ	konishi_kou@example.com
楠 陽子	kusunoki_youko@example.com
赤羽 一輝	akabane_kazuki@example.com
上原 由宇	uehara_yuu@example.com
山川 有起哉	yamakawa_yukiya@example.com
米谷 まひる	yoneya_mahiru@example.com
大平 麻緒	oohira_mao@example.com
鎌田 友以乃	kamata_yuino@example.com
パンツェッタ あや子	panzetta_ayako@example.com
高畑 聡	takahata_satoshi@example.com
宇田川 寿明	udagawa_toshiaki@example.com
相川 崇史	aikawa_takashi@example.com
高倉 きみまろ	takakura_kimimaro@example.com
高橋 直人	takahashi_naoto@example.com
横山 美智子	yokoyama_michiko@example.com
鹿島 綾女	kashima_ayame@example.com
池谷 禄郎	iketani_rokurou@example.com
石倉 真悠子	ishikura_mayuko@example.com
永山 未華子	nagayama_mikako@example.com
難波 完爾	nannba_kanji@example.com
倉持 瑠璃亜	kuramochi_ruria@example.com
真田 秀隆	sanada_hidetaka@example.com
樋口 洋介	higuchi_yousuke@example.com
金谷 美希	kanaya_miki@example.com
佐藤 光良	satou_teruyoshi@example.com
高瀬 路子	takase_michiko@example.com
米田 隆博	yoneda_takahiro@example.com
関根 まなみ	sekine_manami@example.com
福地 未華子	fukuchi_mikako@example.com
小菅 竜也	kosuge_tatsuya@example.com
目黒 満	meguro_mitsuru@example.com
吉岡 美月	yoshioka_miduki@example.com
寺島 那奈	terajima_nana@example.com
加藤 一	katou_hajime@example.com
久野 だん吉	hisano_dankichi@example.com
渡辺 豊	watanabe_yutaka@example.com
塚田 豊	tsukada_yutaka@example.com
赤羽 一恵	akabane_kadue@example.com
野崎 麻緒	nozaki_mao@example.com
飛田 季衣	hida_toshie@example.com
浅利 恵梨香	asari_erika@example.com
森永 恵子	morinaga_keiko@example.com
原口 あおい	haraguchi_aoi@example.com
岩間 碧海	iwama_ouga@example.com
今村 輝信	imamura_akinobu@example.com
堀北 亮介	horikita_ryousuke@example.com
小野 慶太	ono_keita@example.com
及川 勇介	oikawa_yuusuke@example.com
パンツェッタ 優	panzetta_yuu@example.com
松井 めぐみ	matsui_megumi@example.com
松井 聖陽	matsui_masaaki@example.com
沢村 一代	sawamura_kazuyo@example.com
松澤 季衣	matsuzawa_toshie@example.com
柳川 なつみ	yanagawa_natsumi@example.com
寺脇 弘也	terawaki_hironari@example.com
相川 美月	aikawa_miduki@example.com
釈 莉緒	shaku_rio@example.com
伊藤 賢二	itou_kenji@example.com
村瀬 崇史	murase_takashi@example.com
関根 裕司	sekine_yuuji@example.com
氏家 丈雄	ujiie_takeo@example.com
仲田 寿明	nakata_toshiaki@example.com
青野 雅彦	aono_masahiko@example.com
武藤 美佳	mutou_mika@example.com
神木 奈月	kamiki_natsuki@example.com
古谷 小百合	furutani_sayuri@example.com
岡山 さやか	okayama_sayaka@example.com
臼井 優	usui_yuu@example.com
有馬 菜々美	arima_nanami@example.com
山岡 信輔	yamaoka_shinsuke@example.com
加納 さゆり	kanou_sayuri@example.com
畠山 あき	hatayama_aki@example.com
風間 裕司	kazama_yuuji@example.com
出口 和久	deguchi_kazuhisa@example.com
池上 慶二	ikegami_keiji@example.com
坂下 慶二	sakashita_keiji@example.com
木内 圭	kiuchi_kei@example.com
本山 未來	honnyama_mirai@example.com
川野 なつみ	kawano_natsumi@example.com
永島 りえ	nagashima_rie@example.com
志村 七世	shimura_nanase@example.com
小沢 美佐	ozawa_misa@example.com
山上 友以乃	yamagami_yuino@example.com
戸田 草太	toda_souta@example.com
倉本 由宇	kuramoto_yuu@example.com
曽我 ノブヒコ	soga_nobuhiko@example.com
河本 まひる	koumoto_mahiru@example.com
日高 あい	hidaka_ai@example.com
川田 涼	kawata_ryou@example.com
花田 勇介	hanada_yuusuke@example.com
栗山 さやか	kuriyama_sayaka@example.com
正木 徹	masaki_tohru@example.com
大友 莉緒	ootomo_rio@example.com
二宮 みゆき	ninomiya_miyuki@example.com
野沢 耕司	nozawa_kouji@example.com
若山 勝久	wakayama_katsuhisa@example.com
前野 一輝	maeno_kazuki@example.com
本村 結衣	honnmura_yui@example.com
和田 俊二	wada_shunji@example.com
浜本 慶二	hamamoto_keiji@example.com
土屋 耕司	tsuchiya_kouji@example.com
関根 由樹	sekine_yuki@example.com
古田 みあ	furuta_mia@example.com
金城 努	kanashiro_tsutomu@example.com
矢野 裕次郎	yano_yuujirou@example.com
今井 育子	imai_ikuko@example.com
岩佐 獅童	iwasa_shidou@example.com
相川 ジローラモ	aikawa_girolamo@example.com
細川 将也	hosokawa_masaya@example.com
安藤 勝久	anndou_katsuhisa@example.com
有田 浩正	arita_hiromasa@example.com
吹越 勇	fukikoshi_yuu@example.com
芦屋 光洋	ashiya_mitsuhiro@example.com
武井 光博	takei_mitsuhiro@example.com
亀田 彩華	kameda_ayaka@example.com
緒形 明日	ogata_meibi@example.com
木田 三郎	kida_saburou@example.com
松岡 なつみ	matsuoka_natsumi@example.com
竹中 礼子	takenaka_reiko@example.com
小池 美月	koike_miduki@example.com
原 沙耶	hara_saya@example.com
田中 璃奈子	tanaka_rinako@example.com
大崎 みあ	oosaki_mia@example.com
坂上 瞳	sakagami_hitomi@example.com
森下 亮介	morishita_ryousuke@example.com
菊田 希	kikuta_nozomi@example.com
平 誠一	taira_seiichi@example.com
梶原 獅童	kajiwara_shidou@example.com
平野 さんま	hirano_sanma@example.com
木原 璃子	kihara_riko@example.com
沢井 文世	sawai_fumiyo@example.com
木下 裕司	kinoshita_yuuji@example.com
戸田 あさみ	toda_asami@example.com
大浦 隆博	ooura_takahiro@example.com
金井 翔	kanai_shou@example.com
斉藤 敏和	saitou_toshikazu@example.com
石黒 淳	ishiguro_atsushi@example.com
門田 だん吉	kadota_dankichi@example.com
狩野 由宇	kano_yuu@example.com
上村 だん吉	uemura_dankichi@example.com
深谷 陽子	fukaya_youko@example.com
島 将也	shima_masaya@example.com
玉木 由美子	tamaki_yumiko@example.com
岩崎 優	iwasaki_yuu@example.com
藤野 陽介	fujino_yousuke@example.com
染谷 華子	someya_hanako@example.com
立石 晋也	tachiishi_shinya@example.com
三輪 ちえみ	miwa_chiemi@example.com
村山 怜奈	murayama_reina@example.com
深沢 美紀	fukazawa_miki@example.com
大谷 瞬	ootani_shun@example.com
ほしの 美里	hoshino_miri@example.com
前島 真悠子	maejima_mayuko@example.com
村岡 朝陽	muraoka_asahi@example.com
江崎 光洋	ezaki_mitsuhiro@example.com
柳原 優	yanagihara_yuu@example.com
境 健	sakai_ken@example.com
飯田 ヒロ	iida_hiro@example.com
福士 未來	fukushi_mirai@example.com
平沢 ジローラモ	hirasawa_girolamo@example.com
羽田 まなみ	hada_manami@example.com
脇田 まなみ	wakita_manami@example.com
竹内 蒼甫	takeuchi_sousuke@example.com
笠井 真奈美	kasai_manami@example.com
田端 莉央	tabata_rio@example.com
今泉 寿々花	imaizumi_suzuka@example.com
遠山 さゆり	tooyama_sayuri@example.com
上野 美佐子	ueno_misako@example.com
鬼頭 智花	kitou_tomoka@example.com
成瀬 フミヤ	naruse_fumiya@example.com
古沢 亮	furusawa_ryou@example.com
目黒 亜希	meguro_aki@example.com
立川 菜摘	tachikawa_natsumi@example.com
石崎 雅彦	ishizaki_masahiko@example.com
亀山 郁恵	kameyama_ikue@example.com
村木 彩	muraki_aya@example.com
若山 茜	wakayama_akane@example.com
下山 亮	shimoyama_ryou@example.com
福士 朝香	fukushi_asaka@example.com
高橋 怜奈	takahashi_reina@example.com
福島 祐一	fukushima_yuuichi@example.com
柳沢 由宇	yanagisawa_yuu@example.com
木本 美佐子	kimoto_misako@example.com
梅沢 ひとみ	umezawa_hitomi@example.com
長島 ひろみ	nagashima_hiromi@example.com
富田 三省	tomita_sansei@example.com
小出 竜次	koide_ryuuji@example.com
田崎 寛治	tazaki_kanji@example.com
高谷 康文	takaya_yasufumi@example.com
横尾 完爾	yokoo_kanji@example.com
尾形 あさみ	ogata_asami@example.com
福田 知世	fukuda_chise@example.com
竹田 直人	takeda_naoto@example.com
藤森 ひろ子	fujimori_hiroko@example.com
長尾 文世	nagao_fumiyo@example.com
前野 光	maeno_hikaru@example.com
田川 真吾	tagawa_shingo@example.com
根岸 大樹	negishi_hiroki@example.com
樋口 夏希	higuchi_natsuki@example.com
前野 雅彦	maeno_masahiko@example.com
寺岡 努	teraoka_tsutomu@example.com
志村 路子	shimura_michiko@example.com
安部 裕司	abe_yuuji@example.com
増井 芳正	masui_yoshimasa@example.com
木下 誠一	kinoshita_seiichi@example.com
本多 みき	honnda_miki@example.com
小口 輝信	oguchi_akinobu@example.com
森永 亜希	morinaga_aki@example.com
相原 サンタマリア	aihara_stmaria@example.com
武藤 美咲	mutou_misaki@example.com
矢島 直人	yajima_naoto@example.com
今井 正義	imai_masayoshi@example.com
落合 夏空	ochiai_sora@example.com
滝本 マサカズ	takimoto_masakazu@example.com
竹村 麗奈	takemura_rena@example.com
河野 沙知絵	kawano_sachie@example.com
一木 あい	ichiki_ai@example.com
関口 明慶	sekiguchi_akiyoshi@example.com
小野田 莉沙	onoda_risa@example.com
桜田 真奈美	sakurada_manami@example.com
小野 ジローラモ	ono_girolamo@example.com
篠崎 光	shinozaki_hikaru@example.com
三好 敏也	miyoshi_toshiya@example.com
寺島 里奈	terajima_rina@example.com
大場 由宇	ooba_yuu@example.com
三橋 寛治	mihashi_kanji@example.com
梅村 由宇	umemura_yuu@example.com
北 恵梨香	kita_erika@example.com
志村 ちえみ	shimura_chiemi@example.com
宇佐美 芳正	usami_yoshimasa@example.com
北条 浩太郎	houjou_koutarou@example.com
山城 正義	yamashiro_masayoshi@example.com
渡辺 知世	watanabe_chise@example.com
岩井 明	iwai_akira@example.com
亀井 美月	kamei_miduki@example.com
宇田川 璃子	udagawa_riko@example.com
森井 麻由子	morii_mayuko@example.com
窪塚 華子	kuboduka_hanako@example.com
池本 豊	ikemoto_yutaka@example.com
大庭 翔	ooniwa_shou@example.com
野沢 美帆	nozawa_miho@example.com
渋谷 奈々	shibuya_nana@example.com
柴田 一	shibata_hajime@example.com
田淵 南朋	tabuchi_nao@example.com
平 サンタマリア	taira_stmaria@example.com
笹川 りえ	sasagawa_rie@example.com
森谷 朝香	moriya_asaka@example.com
手塚 りえ	teduka_rie@example.com
草村 景子	kusamura_keiko@example.com
梅田 真希	umeda_maki@example.com
倉持 竜次	kuramochi_ryuuji@example.com
山内 有起哉	yamanouchi_yukiya@example.com
横山 雅之	yokoyama_masayuki@example.com
大原 友也	oohara_tomoya@example.com
草村 正義	kusamura_masayoshi@example.com
神山 りえ	kamiyama_rie@example.com
内田 輝信	uchida_akinobu@example.com
川添 淳子	kawazoe_atsuko@example.com
広末 怜奈	hirosue_reina@example.com
原 サダヲ	hara_sadawo@example.com
福士 聖陽	fukushi_masaaki@example.com
早川 光	hayakawa_hikaru@example.com
松本 栄一	matsumoto_eiichi@example.com
牧瀬 友香	makise_tomoka@example.com
石原 友以乃	ishihara_yuino@example.com
高岡 隆	takaoka_takashi@example.com
新垣 茂樹	niigaki_shigeki@example.com
神山 慶太	kamiyama_keita@example.com
小菅 雅功	kosuge_masatoshi@example.com
大坂 一恵	oosaka_kadue@example.com
水崎 祐一	misaki_yuuichi@example.com
古田 優	furuta_yuu@example.com
橋爪 洋介	hashidume_yousuke@example.com
今川 功補	imagawa_kousuke@example.com
西村 玲那	nishimura_rena@example.com
大山 人志	ooyama_hitoshi@example.com
近藤 景子	kondou_keiko@example.com
細川 了	hosokawa_ryou@example.com
石原 南朋	ishihara_nao@example.com
市村 千佳子	ichimura_chikako@example.com
榊原 秀樹	sakakibara_hideki@example.com
池内 優	ikeuchi_yuu@example.com
安藤 剛基	ando_yoshiki@example.com
岩永 詩織	iwanaga_shiori@example.com
本橋 知史	motohashi_tomofumi@example.com
布川 あや子	fukawa_ayako@example.com
長谷 愛菜	nagaya_aina@example.com
三好 彩華	miyoshi_ayaka@example.com
水嶋 薫	mizushima_kaoru@example.com
宇田川 法嗣	udagawa_houshi@example.com
植木 博明	ueki_hiroaki@example.com
桜井 はじめ	sakurai_hajime@example.com
村上 陽子	murakami_youko@example.com
津田 みき	tsuda_miki@example.com
石渡 寛治	ishiwatari_kanji@example.com
東 由樹	higashi_yuki@example.com
森谷 咲	moriya_saki@example.com
島津 なつみ	shimadu_natsumi@example.com
大沢 洋	oosawa_you@example.com
城田 希	shirota_nozomi@example.com
福地 陽介	fukuchi_yousuke@example.com
藤井 栄一	fujii_eiichi@example.com
相沢 惇	aizawa_atsushi@example.com
内田 寿明	uchida_toshiaki@example.com
梶原 璃奈子	kajiwara_rinako@example.com
藤岡 竜也	fujioka_tatsuya@example.com
橋本 雅彦	hashimoto_masahiko@example.com
宮崎 鉄洋	miyazaki_tetsuhiro@example.com
内山 菜摘	uchiyama_natsumi@example.com
真矢 佑	maya_tasuku@example.com
倉持 裕司	kuramochi_yuuji@example.com
楠 宏行	kusunoki_hiroyuki@example.com
長島 宏行	nagashima_hiroyuki@example.com
丸山 きみまろ	maruyama_kimimaro@example.com
浜崎 敏和	hamasaki_toshikazu@example.com
本村 菜々美	honnmura_nanami@example.com
山中 奈月	yamanaka_natsuki@example.com
福岡 未來	fukuoka_mirai@example.com
岩城 あさみ	iwaki_asami@example.com
朝倉 砂羽	asakura_sawa@example.com
水口 華子	mizuguchi_hanako@example.com
首藤 六郎	sudou_rokurou@example.com
福本 守	fukumoto_mamoru@example.com
原口 玲那	haraguchi_rena@example.com
楠本 エリカ	kusumoto_erika@example.com
満島 ひとみ	mitsushima_hitomi@example.com
村上 充則	murakami_mitsunori@example.com
高瀬 恵梨香	takase_erika@example.com
堤 たまき	tsutsumi_tamaki@example.com
大下 光博	ooshita_mitsuhiro@example.com
植田 輝信	ueta_akinobu@example.com
北村 雅彦	kitamura_masahiko@example.com
石井 豊	ishii_yutaka@example.com
守屋 瞬	moriya_shun@example.com
片桐 鉄二	katagiri_tetsuji@example.com
瀬戸 真悠子	seto_mayuko@example.com
南部 景子	nannbu_keiko@example.com
松原 一哉	matsubara_kazuya@example.com
北村 長利	kitamura_nagatoshi@example.com
相原 豊	aihara_yutaka@example.com
松下 美紀	matsushita_miki@example.com
浅田 鉄二	asada_tetsuji@example.com
少路 昌代	shouji_masayo@example.com
松下 サンタマリア	matsushita_stmaria@example.com
松居 茜	matsui_akane@example.com
相沢 宏行	aizawa_hiroyuki@example.com
寺本 晃司	teramoto_kouji@example.com
黒木 博明	kuroki_hiroaki@example.com
薬師丸 達士	yakushimaru_tatsuhito@example.com
小原 美月	ohara_miduki@example.com
伴 惇	ban_jun@example.com
児玉 豊	kodama_yutaka@example.com
土田 寛	tsuchida_hiroshi@example.com
今井 努	imai_tsutomu@example.com
高野 そら	takano_sora@example.com
石川 明	ishikawa_akira@example.com
浜本 一哉	hamamoto_kazuya@example.com
原口 そら	haraguchi_sora@example.com
浅田 美幸	asada_miyuki@example.com
竹田 米蔵	takeda_yonezou@example.com
入江 美紀	irie_miki@example.com
花岡 菊生	hanaoka_kikuo@example.com
木村 豊	kimura_yutaka@example.com
小口 サンタマリア	oguchi_stmaria@example.com
伴 和之	ban_kazuyuki@example.com
美木 恵梨香	miki_erika@example.com
平塚 優	hiratsuka_yuu@example.com
奥寺 はじめ	okudera_hajime@example.com
沢井 優	sawai_yuu@example.com
ほしの 亮介	hoshino_ryousuke@example.com
山上 寿々花	yamagami_suzuka@example.com
田崎 ひろみ	tazaki_hiromi@example.com
福士 研二	fukushi_kenji@example.com
吉永 勝久	yoshinaga_katsuhisa@example.com
大和田 春樹	oowada_haruki@example.com
池谷 勤	iketani_tsutomu@example.com
伊藤 淳子	itou_atsuko@example.com
増田 春樹	masuda_haruki@example.com
黒岩 早織	kuroiwa_saori@example.com
田端 美佐	tabata_misa@example.com
平塚 ケンイチ	hiratsuka_kenichi@example.com
小田 芽以	oda_mei@example.com
福田 奈々	fukuda_nana@example.com
片桐 勇太	katagiri_yuuta@example.com
畑 徹	hatake_tooru@example.com
大熊 はるか	ookuma_haruka@example.com
児玉 亜希	kodama_aki@example.com
須藤 樹里	sudou_juri@example.com
瀬戸 将也	seto_masaya@example.com
矢部 晋也	yabe_shinya@example.com
井手 良介	ide_ryousuke@example.com
吉田 遥	yoshida_haruka@example.com
加藤 遥	katou_haruka@example.com
大平 あい	oohira_ai@example.com
阪口 璃子	sakaguchi_riko@example.com
向井 朝陽	murai_asahi@example.com
池谷 愛子	iketani_aiko@example.com
橋本 さとみ	hashimoto_satomi@example.com
前原 利夫	maehara_toshio@example.com
喜多 恵美	kita_megumi@example.com
市原 瞬	ichihara_shun@example.com
原 ひかり	hara_hikari@example.com
美木 一徳	miki_ittoku@example.com
吉井 貴美子	yoshii_kimiko@example.com
広末 さやか	hirosue_sayaka@example.com
葛山 晴臣	katsurayama_haruomi@example.com
永瀬 亜希	nagase_aki@example.com
大友 さやか	ootomo_sayaka@example.com
三村 碧海	mimura_ouga@example.com
深谷 完爾	fukaya_kanji@example.com
川畑 由宇	kawahata_yuu@example.com
松澤 遥	matsuzawa_haruka@example.com
水嶋 倫子	mizushima_noriko@example.com
上野 沙耶	ueno_saya@example.com
勝地 誠治	katsudi_seiji@example.com
加瀬 瞳	kase_hitomi@example.com
百瀬 さゆり	momose_sayuri@example.com
ともさか 光良	tomosaka_teruyoshi@example.com
金田 浩正	kaneda_hiromasa@example.com
中野 由宇	nakano_yuu@example.com
根岸 正敏	negishi_masatoshi@example.com
加藤 恵梨香	katou_erika@example.com
武藤 なつみ	mutou_natsumi@example.com
坂本 恵子	sakamoto_keiko@example.com
田畑 優	tabata_yuu@example.com
徳田 一哉	tokuta_kazuya@example.com
芦田 育子	ashida_ikuko@example.com
神保 直人	jinbo_naoto@example.com
井上 崇史	inoue_takashi@example.com
大城 未來	ooshiro_mirai@example.com
藤沢 ひろ子	fujisawa_hiroko@example.com
吉野 獅童	yoshino_shidou@example.com
出口 育二	deguchi_ikuji@example.com
七瀬 はるみ	nanase_harumi@example.com
倉本 奈々	kuramoto_nana@example.com
大河内 隆之介	ookouchi_ryuunosuke@example.com
塚田 康文	tsukada_yasufumi@example.com
大西 めぐみ	oonishi_megumi@example.com
杉原 莉緒	sugihara_rio@example.com
岩谷 薫	iwatani_kaoru@example.com
西尾 砂羽	nishio_sawa@example.com
岩佐 文世	iwasa_fumiyo@example.com
河田 誠一	kawata_seiichi@example.com
佐藤 幸平	satou_kouhei@example.com
山崎 健	yamazaki_ken@example.com
土屋 あき	tsuchiya_aki@example.com
会田 愛	aida_ai@example.com
奥田 智花	okuda_tomoka@example.com
川島 まみ	kawashima_mami@example.com
佐野 淳子	sano_atsuko@example.com
江崎 希	ezaki_nozomi@example.com
宇都宮 一恵	utsunomiya_kadue@example.com
芹沢 秀隆	serizawa_hidetaka@example.com
浅野 仁晶	asano_hiroaki@example.com
平川 菜摘	hirakawa_natsumi@example.com
中原 遥	nakahara_haruka@example.com
浜崎 裕司	hamasaki_yuuji@example.com
河西 研二	kawanishi_kenji@example.com
井上 美幸	inoue_miyuki@example.com
熊倉 惇	kumakura_atsushi@example.com
田口 マサカズ	taguchi_masakazu@example.com
三好 優	miyoshi_yuu@example.com
長崎 勤	nagasaki_tsutomu@example.com
天野 みゆき	amano_miyuki@example.com
大後 徹平	oogo_teppei@example.com
古谷 鉄二	furutani_tetsuji@example.com
井本 恵美	imoto_megumi@example.com
伊藤 奈々	itou_nana@example.com
伊藤 基祐	itou_kisuke@example.com
小川 ひとり	ogawa_hitori@example.com
石川 真悠子	ishikawa_mayuko@example.com
手塚 栄一	teduka_eiichi@example.com
鹿手袋 綾	shikatebukuro_aya@example.com
江口 茜	eguchi_akane@example.com
緒方 璃奈子	ogata_rinako@example.com
安田 沙知絵	yasuda_sachie@example.com
菅沼 裕司	suganuma_yuuji@example.com
池畑 砂羽	ikehata_sawa@example.com
影山 慢太郎	kageyama_mantarou@example.com
金山 光良	kanayama_teruyoshi@example.com
小幡 豊	obata_yutaka@example.com
寺島 ジョージ	terajima_george@example.com
生田 未來	namata_mirai@example.com
安座間 竜也	azama_tatsuya@example.com
吉永 景子	yoshinaga_keiko@example.com
鹿賀 茜	kaga_akane@example.com
明石 恵梨香	akashi_erika@example.com
飯野 染五郎	iino_somegorou@example.com
劇団 隆博	gekidan_takahiro@example.com
生田 瑠璃亜	namata_ruria@example.com
入江 杏	irie_ann@example.com
武井 寿明	takei_toshiaki@example.com
長野 京子	nagano_kyouko@example.com
平岡 あい	hiraoka_ai@example.com
辻 仁	tsuji_jin@example.com
大高 隆之介	oodaka_ryuunosuke@example.com
矢口 由宇	yaguchi_yuu@example.com
戎 紗季	ebisu_saki@example.com
浅野 由樹	asano_yuki@example.com
関根 エリカ	sekine_erika@example.com
斉藤 研二	saitou_kenji@example.com
坂本 法子	sakamoto_noriko@example.com
坂本 恵子	sakamoto_keiko1@example.com
真矢 咲	maya_saki@example.com
岩沢 ヒロ	iwasawa_hiro@example.com
伊藤 瞬	itou_shun@example.com
畠中 そら	hatanaka_sora@example.com
神山 宏行	kamiyama_hiroyuki@example.com
阪本 晋也	sakamoto_shinya@example.com
米沢 秀樹	yonezawa_hideki@example.com
田辺 さとみ	tanabe_satomi@example.com
峰 ヒカル	mine_hikaru@example.com
沢田 菜々美	sawada_nanami@example.com
寺脇 龍吉	terawaki_ryuukichi@example.com
対馬 薫	tsushima_kaoru@example.com
吉沢 克実	yoshizawa_katsumi@example.com
北 満	kita_mitsuru@example.com
伴 浩正	ban_hiromasa@example.com
草村 恵麻	kusamura_ema@example.com
一木 郁恵	ichiki_ikue@example.com
草村 大五郎	kusamura_daigorou@example.com
山村 憲一	yamamura_kenichi@example.com
奥村 慎之介	okumura_shinnosuke@example.com
荻野 里奈	ogino_rina@example.com
合田 ひかり	aida_hikari@example.com
志村 美帆	shimura_miho@example.com
鹿島 美帆	kashima_miho@example.com
竹原 悟志	takehara_satoshi@example.com
邑野 勇一	murano_yuuichi@example.com
玉木 陽子	tamaki_youko@example.com
野島 咲	nojima_saki@example.com
池上 景子	ikegami_keiko@example.com
宇都宮 進	utsunomiya_susumu@example.com
佐藤 守	satou_mamoru@example.com
小池 米蔵	koike_yonezou@example.com
吉岡 勇	yoshioka_yuu@example.com
堀田 勝久	hotta_katsuhisa@example.com
細谷 璃奈子	hosoya_rinako@example.com
梅津 勇一	umedu_yuuichi@example.com
安藤 恵梨香	anndou_erika@example.com
有田 育二	arita_ikuji@example.com
林 璃子	hayashi_riko@example.com
竹本 聡	takemoto_satoshi@example.com
曽我 菜摘	soga_natsumi@example.com
長澤 優一	nagasawa_yuuichi@example.com
小松 大五郎	komatsu_daigorou@example.com
中塚 染五郎	nakaduka_somegorou@example.com
猪股 信輔	inomata_shinsuke@example.com
中岡 涼子	nakaoka_ryouko@example.com
亀山 亮	kameyama_ryou@example.com
緒方 彩	ogata_aya@example.com
神木 たかお	kamiki_takao@example.com
川越 茜	kawagoe_akane@example.com
土田 杏	tsuchida_ann@example.com
野本 景子	nomoto_keiko@example.com
永島 桃子	nagashima_momoko@example.com
外山 幸子	sotoyama_sachiko@example.com
瀬戸 七世	seto_nanase@example.com
井原 三省	ihara_sansei@example.com
森永 砂羽	morinaga_sawa@example.com
塩谷 瑠璃亜	shioya_ruria@example.com
岩田 丈雄	iwata_takeo@example.com
内野 洋	uchino_you@example.com
北原 健	kitahara_ken@example.com
石井 恵望子	ishii_emiko@example.com
北田 寛	kitada_hiroshi@example.com
秋元 徹平	akimoto_teppei@example.com
宮島 真奈美	miyajima_manami@example.com
荒木 莉緒	araki_rio@example.com
前田 哲平	maeda_teppei@example.com
門田 宏	kadota_hiroshi@example.com
緒形 由宇	ogata_yuu@example.com
石黒 明慶	ishiguro_akiyoshi@example.com
堀越 遥	horikoshi_haruka@example.com
丹野 亜希	tannno_aki@example.com
津田 京子	tsuda_kyouko@example.com
塚原 まさし	tsukahara_masashi@example.com
江藤 恵美	etou_megumi@example.com
吉永 敏和	yoshinaga_toshikazu@example.com
勝又 勇太	katsumata_yuuta@example.com
近藤 惇	konndou_jun@example.com
田淵 光良	tabuchi_teruyoshi@example.com
井沢 浩介	izawa_kousuke@example.com
工藤 直人	kudou_naoto@example.com
大坪 倫子	ootsubo_noriko@example.com
熊井 和之	kumai_kazuyuki@example.com
南 メイサ	minami_meisa@example.com
小田 光良	oda_teruyoshi@example.com
福士 明	fukushi_akira@example.com
土田 一代	tsuchida_kazuyo@example.com
小西 信輔	konishi_shinsuke@example.com
森脇 育二	moriwaki_ikuji@example.com
大森 晴臣	oomori_haruomi@example.com
藤村 光臣	fujimura_mitsuomi@example.com
庄司 文世	shouji_fumiyo@example.com
島本 遥	shimamoto_haruka@example.com
松井 莉緒	matsui_rio@example.com
大友 大五郎	ootomo_daigorou@example.com
池田 早織	ikeda_saori@example.com
武 あい	take_ai@example.com
牧野 明宏	makino_akihiro@example.com
尾崎 璃子	ozaki_riko@example.com
柳原 功補	yanagihara_kousuke@example.com
前川 聡	maekawa_satoshi@example.com
倉本 明	kuramoto_akira@example.com
下田 翔子	shimoda_shouko@example.com
吉田 コウ	yoshida_kou@example.com
石崎 有海	ishizaki_ami@example.com
秋田 育子	akita_ikuko@example.com
城戸 綾	kido_aya@example.com
北原 美月	kitahara_miduki@example.com
中根 優	nakane_yuu@example.com
合田 たまき	aida_tamaki@example.com
関根 真悠子	sekine_mayuko@example.com
畠山 佑	hatayama_tasuku@example.com
井上 妃里	inoue_yuri@example.com
今西 早織	imanishi_saori@example.com
北原 咲	kitahara_saki@example.com
岡本 守	okamoto_mamoru@example.com
秋葉 奈月	akiba_natsuki@example.com
木原 結衣	kihara_yui@example.com
加藤 千夏	katou_chinatsu@example.com
池上 美紀	ikegami_miki@example.com
松岡 寿明	matsuoka_toshiaki@example.com
小林 きみまろ	kobayashi_kimimaro@example.com
真矢 進	maya_susumu@example.com
岩田 知史	iwata_tomofumi@example.com
柏木 さんま	kashiwagi_sanma@example.com
吉沢 竜次	yoshizawa_ryuuji@example.com
熊倉 竜也	kumakura_tatsuya@example.com
岩佐 なつみ	iwasa_natsumi@example.com
玉田 遥	tamada_haruka@example.com
沢田 さんま	sawada_sanma@example.com
森永 美里	morinaga_miri@example.com
高尾 メイサ	takao_meisa@example.com
浅野 恭子	asano_kyouko@example.com
吉岡 真一	yoshioka_shinichi@example.com
久米 まみ	kume_mami@example.com
藤木 碧海	fujiki_ouga@example.com
上杉 友香	uesugi_tomoka@example.com
二宮 たかお	ninomiya_takao@example.com
宮下 フミヤ	miyashita_fumiya@example.com
岸 聡	kishi_satoshi@example.com
小坂 美佳	kozaka_mika@example.com
大貫 恵梨香	oonuki_erika@example.com
水川 さゆり	mizukawa_sayuri@example.com
平沢 碧海	hirasawa_ouga@example.com
足立 しほり	adachi_shihori@example.com
大塚 くるみ	ootsuka_kurumi@example.com
小泉 れいな	koizumi_reina@example.com
野中 兼	nonaka_ken@example.com
萩原 ヒカル	hagiwara_hikaru@example.com
神保 洋介	jinbo_yousuke@example.com
磯村 友也	isomura_tomoya@example.com
堀江 さんま	horie_sanma@example.com
筧 みあ	kakei_mia@example.com
吉崎 咲	yoshizaki_saki@example.com
小西 明宏	konishi_akihiro@example.com
菅野 広司	sugano_kouji@example.com
大路 弘也	ooji_hironari@example.com
千葉 浩介	chiba_kousuke@example.com
大西 亮	oonishi_ryou@example.com
三船 光博	mifune_mitsuhiro@example.com
波多野 コウ	hatano_kou@example.com
松沢 昴	matsuzawa_subaru@example.com
高岡 早紀	takaoka_saki@example.com
小泉 友以乃	koizumi_yuino@example.com
矢野 啓介	yano_keisuke@example.com
平岡 砂羽	hiraoka_sawa@example.com
岡本 賢治	okamoto_kenji@example.com
横田 徹平	yokota_teppei@example.com
石沢 美優	ishizawa_myuu@example.com
小柳 隆	koyanagi_takashi@example.com
川合 慢太郎	kawai_mantarou@example.com
山城 雅之	yamashiro_masayuki@example.com
江崎 明	ezaki_akira@example.com
高島 沙知絵	takashima_sachie@example.com
大野 竜也	oono_tatsuya@example.com
真田 昴	sanada_subaru@example.com
米谷 奈々	yoneya_nana@example.com
石垣 朝香	ishigaki_asaka@example.com
田口 コウ	taguchi_kou@example.com
八田 有海	yatsuda_ami@example.com
三好 豊	miyoshi_yutaka@example.com
佐竹 雅之	satake_masayuki@example.com
宮崎 昌代	miyazaki_masayo@example.com
庄司 獅童	shouji_shidou@example.com
城田 真希	shirota_maki@example.com
宇野 ちえみ	uno_chiemi@example.com
川口 ひかり	kawaguchi_hikari@example.com
立川 夏希	tachikawa_natsuki@example.com
五大 光	godai_hikaru@example.com
杉山 さとみ	sugiyama_satomi@example.com
高木 みゆき	takagi_miyuki@example.com
比嘉 優	hiyoshi_yuu@example.com
伊丹 将也	itami_masaya@example.com
山上 直人	yamagami_naoto@example.com
本間 あき	honnma_aki@example.com
青山 春樹	aoyama_haruki@example.com
奥山 真吾	okuyama_shingo@example.com
原 杏	hara_ann@example.com
菅澤 一恵	sugasawa_kadue@example.com
小池 マサカズ	koike_masakazu@example.com
真鍋 照生	manabe_teruo@example.com
宮坂 サンタマリア	miyasaka_stmaria@example.com
徳重 ケンイチ	tokushige_kenichi@example.com
境 徹	sakai_tooru@example.com
進藤 奈央	shinndou_nao@example.com
池谷 結子	iketani_yuuko@example.com
秋田 千夏	akita_chinatsu@example.com
野村 優	nomura_yuu@example.com
三浦 真悠子	miura_mayuko@example.com
荒川 佑	arakawa_tasuku@example.com
河原 結子	kawahara_yuuko@example.com
松川 マサカズ	matsukawa_masakazu@example.com
塩谷 彩	shioya_aya@example.com
品川 なつみ	shinagawa_natsumi@example.com
邑野 寛治	murano_kanji@example.com
小日向 美帆	kohinata_miho@example.com
半田 沙耶	hannda_saya@example.com
深沢 碧海	fukazawa_ouga@example.com
城田 亮	shirota_ryou@example.com
横井 竜次	yokoi_ryuuji@example.com
奥 竜也	oku_tatsuya@example.com
平田 佑	hirata_tasuku@example.com
有賀 憲史	ariga_norihito@example.com
諏訪 なつみ	suwa_natsumi@example.com
大泉 ひろみ	ooizumi_hiromi@example.com
栗林 かおり	kuribayashi_kaori@example.com
小市 光臣	koichi_mitsuomi@example.com
池本 長利	ikemoto_nagatoshi@example.com
有馬 薫	arima_kaoru@example.com
柏原 里奈	kashiwara_rina@example.com
堀越 守	horikoshi_mamoru@example.com
川瀬 佳乃	kawase_yoshino@example.com
林田 竜也	hayashida_tatsuya@example.com
相沢 さとみ	aizawa_satomi@example.com
亀井 千佳子	kamei_chikako@example.com
安井 涼子	yasui_ryouko@example.com
杉田 まさみ	sugita_masami@example.com
尾崎 草太	ozaki_souta@example.com
大矢 晃司	ooya_kouji@example.com
小坂 かおり	kozaka_kaori@example.com
三木 勇太	miki_yuuta@example.com
岩谷 信輔	iwatani_shinsuke@example.com
長崎 里奈	nagasaki_rina@example.com
早美 たかお	hayami_takao@example.com
大川 ひろみ	ookawa_hiromi@example.com
北 遥	kita_haruka@example.com
野田 建	noda_ken@example.com
花岡 真帆	hanaoka_maho@example.com
橋口 翔太	hashiguchi_shouta@example.com
相川 里穂	aikawa_riho@example.com
野呂 勝久	noro_katsuhisa@example.com
小杉 ジョージ	kosugi_george@example.com
南部 完爾	nannbu_kanji@example.com
木内 一恵	kiuchi_kadue@example.com
二宮 幸子	ninomiya_sachiko@example.com
半田 知世	hannda_chise@example.com
米沢 満	yonezawa_mitsuru@example.com
大浦 メイサ	ooura_meisa@example.com
薬師丸 竜次	yakushimaru_ryuuji@example.com
桑田 大五郎	kuwata_daigorou@example.com
石本 桃子	ishimoto_momoko@example.com
三宅 那奈	miyake_nana@example.com
水野 友香	mizuno_tomoka@example.com
小池 隆太	koike_ryuuta@example.com
今泉 昴	imaizumi_subaru@example.com
水谷 誠治	mizutani_seiji@example.com
塩田 そら	shiota_sora@example.com
野島 早織	nojima_saori@example.com
真矢 守	maya_mamoru@example.com
菊田 竜也	kikuta_tatsuya@example.com
市川 花緑	ichikawa_karoku@example.com
矢部 愛	yabe_ai@example.com
大森 聡	oomori_satoshi@example.com
日高 恵麻	hidaka_ema@example.com
多岐川 達士	takigawa_tatsuhito@example.com
水嶋 勝久	mizushima_katsuhisa@example.com
恩田 一樹	onnda_kazuki@example.com
中原 さとみ	nakahara_satomi@example.com
池本 祐一	ikemoto_yuuichi@example.com
大倉 和久	ookura_kazuhisa@example.com
瀬川 真吾	segawa_shingo@example.com
志田 聡	shida_satoshi@example.com
坂元 誠一	sakamoto_seiichi@example.com
青柳 遥	aoyagi_haruka@example.com
小泉 惇	koizumi_atsushi@example.com
西原 はるか	nishihara_haruka@example.com
高畑 季衣	takabata_toshie@example.com
加藤 雅彦	katou_masahiko@example.com
吉野 宏行	yoshino_hiroyuki@example.com
花岡 知史	hanaoka_tomofumi@example.com
浅見 里奈	asami_rina@example.com
山元 誠治	yamamoto_seiji@example.com
岩佐 草太	iwasa_souta@example.com
喜多 瞳	kita_hitomi@example.com
坂下 礼子	sakashita_reiko@example.com
緒形 徹	ogata_tohru@example.com
内野 浩太郎	uchino_koutarou@example.com
市村 綾女	ichimura_ayame@example.com
志村 大	shimura_masaru@example.com
大塚 まさし	ootsuka_masashi@example.com
岩瀬 早織	iwase_saori@example.com
久野 里奈	hisano_rina@example.com
柴田 奈々	shibata_nana@example.com
島田 夏希	shimada_natsuki@example.com
岩下 菜摘	iwashita_natsumi@example.com
仲村 路子	nakamura_michiko@example.com
板橋 ヒロ	itabashi_hiro@example.com
小菅 莉央	kosuge_rio@example.com
古谷 兼	furutani_ken@example.com
伊崎 高史	isaki_takashi@example.com
加瀬 新太	kase_arata@example.com
吉田 由樹	yoshida_yuki@example.com
野崎 マサカズ	nozaki_masakazu@example.com
八木 弘也	yagi_hironari@example.com
畠中 美嘉	hatanaka_mika@example.com
柳沢 建	yanagisawa_ken@example.com
遠山 悟志	tooyama_satoshi@example.com
井上 晴臣	inoue_haruomi@example.com
戎 しぼり	ebisu_shibori@example.com
葛山 真悠子	katsurayama_mayuko@example.com
安部 あさみ	abe_asami@example.com
筒井 啓介	tsutsui_keisuke@example.com
水川 奈央	mizukawa_nao@example.com
金山 達士	kanayama_tatsuhito@example.com
西川 一	nishikawa_hajime@example.com
藤澤 恵子	fujisawa_keiko@example.com
磯野 真奈美	isono_manami@example.com
平山 妃里	hirayama_yuri@example.com
仲村 佳乃	nakamura_yoshino@example.com
重田 真吾	shigeta_shingo@example.com
酒井 麻緒	sakai_mao@example.com
吉田 礼子	yoshida_reiko@example.com
百瀬 ヒロ	momose_hiro@example.com
小堀 祐基	kohori_yuuki@example.com
南部 ひろみ	nannbu_hiromi@example.com
深沢 弘也	fukazawa_hironari@example.com
三枝 陽子	sannshi_youko@example.com
庄司 敦	shouji_atsushi@example.com
塩沢 浩介	shiozawa_kousuke@example.com
日野 将也	hino_masaya@example.com
三浦 倫子	miura_noriko@example.com
伊藤 寿々花	itou_suzuka@example.com
永井 翔	nagai_shou@example.com
豊島 達士	toyoshima_tatsuhito@example.com
水谷 愛	mizutani_ai@example.com
河内 希	kawauchi_nozomi@example.com
水上 ヒロ	mizukami_hiro@example.com
高樹 建	takagi_ken@example.com
遠藤 菊生	enndou_kikuo@example.com
高樹 あき	takagi_aki@example.com
柏木 里奈	kashiwagi_rina@example.com
橋口 竜也	hashiguchi_tatsuya@example.com
小椋 隆	ogura_takashi@example.com
横井 涼子	yokoi_ryouko@example.com
島津 瞬	shimadu_shun@example.com
芹沢 あおい	serizawa_aoi@example.com
本橋 あおい	motohashi_aoi@example.com
田尻 フミヤ	tajiri_fumiya@example.com
近藤 くるみ	konndou_kurumi@example.com
黄川田 翔太	kikawada_shouta@example.com
河本 瞬	koumoto_shun@example.com
阿久津 直人	akutsu_naoto@example.com
伊藤 雅彦	itou_masahiko@example.com
村松 輝信	muramatsu_akinobu@example.com
堀口 寿明	horiguchi_toshiaki@example.com
根本 璃奈子	nemoto_rinako@example.com
坂口 晃司	sakaguchi_kouji@example.com
水野 由樹	mizuno_yuki@example.com
国分 綾	kokubunn_aya@example.com
古賀 啓介	koga_keisuke@example.com
大林 亮介	oobayashi_ryousuke@example.com
大高 大五郎	oodaka_daigorou@example.com
今野 知世	imano_chise@example.com
古沢 光臣	furusawa_mitsuomi@example.com
上条 徹	kamijou_tooru@example.com
満島 寿々花	mitsushima_suzuka@example.com
塚田 徹平	tsukada_teppei@example.com
下田 あや子	shimoda_ayako@example.com
岡本 雅彦	okamoto_masahiko@example.com
橘 徹平	tachibana_teppei@example.com
田島 惇	tajima_jun@example.com
小椋 長利	ogura_nagatoshi@example.com
畑中 あさみ	hatanaka_asami@example.com
内野 隼士	uchino_shunji@example.com
小幡 和久	obata_kazuhisa@example.com
境 美希	sakai_miki@example.com
橘 友以乃	tachibana_yuino@example.com
大谷 惇	ootani_atsushi@example.com
小日向 達士	kohinata_tatsuhito@example.com
武井 広司	takei_kouji@example.com
小泉 美希	koizumi_miki@example.com
井本 大五郎	imoto_daigorou@example.com
梅本 夏希	umemoto_natsuki@example.com
寺島 了	terajima_ryou@example.com
河田 エリカ	kawata_erika@example.com
峰 マサカズ	mine_masakazu@example.com
磯村 法子	isomura_noriko@example.com
牧田 杏	makita_ann@example.com
渡部 窈	watabe_you@example.com
守屋 まなみ	moriya_manami@example.com
松井 碧海	matsui_ouga@example.com
柳 はるみ	yanagi_harumi@example.com
有賀 美智子	ariga_michiko@example.com
福士 サダヲ	fukushi_sadawo@example.com
池本 寿々花	ikemoto_suzuka@example.com
浦野 光	urano_hikaru@example.com
小池 砂羽	koike_sawa@example.com
相沢 茂樹	aizawa_shigeki@example.com
三枝 はるか	sannshi_haruka@example.com
河原 フミヤ	kawahara_fumiya@example.com
植村 ヒカル	uemura_hikaru@example.com
村井 恵望子	murai_emiko@example.com
奥田 美優	okuda_myuu@example.com
紺野 和香	konnno_waka@example.com
滝口 洋介	takiguchi_yousuke@example.com
黒木 聡	kuroki_satoshi@example.com
大槻 亮	ootsuki_ryou@example.com
有村 早織	arimura_saori@example.com
永井 ジローラモ	nagai_girolamo@example.com
松野 丈雄	matsuno_takeo@example.com
松居 小雁	matsui_kogan@example.com
石渡 法子	ishiwatari_noriko@example.com
大城 愛梨	ooshiro_airi@example.com
本上 綾女	honjo_ayame@example.com
本山 麗奈	honnyama_rena@example.com
西原 めぐみ	nishihara_megumi@example.com
児島 努	kojima_tsutomu@example.com
東 浩介	higashi_kousuke@example.com
松崎 早紀	matsuzaki_saki@example.com
田淵 照生	tabuchi_teruo@example.com
久米 一哉	kume_kazuya@example.com
佐藤 将也	satou_masaya@example.com
菅 聖陽	suga_masaaki@example.com
安倍 莉沙	abe_risa@example.com
松沢 充則	matsuzawa_mitsunori@example.com
川口 晋也	kawaguchi_shinya@example.com
二宮 努	ninomiya_tsutomu@example.com
藤井 千佳子	fujii_chikako@example.com
はしの 砂羽	hashino_sawa@example.com
吉田 慢太郎	yoshida_mantarou@example.com
今 将也	ima_masaya@example.com
大下 早紀	ooshita_saki@example.com
秋元 千佳子	akimoto_chikako@example.com
川端 恵美	kawabata_megumi@example.com
川端 美幸	kawabata_miyuki@example.com
小菅 博明	kosuge_hiroaki@example.com
上村 賢二	uemura_kenji@example.com
馬場 美帆	baba_miho@example.com
久保田 怜奈	kubota_reina@example.com
松居 理紗	matsui_risa@example.com
川田 かおり	kawata_kaori@example.com
森口 浩太郎	moriguchi_koutarou@example.com
桑田 豊	kuwata_yutaka@example.com
高野 蒼甫	takano_sousuke@example.com
田原 みき	tahara_miki@example.com
木本 詩織	kimoto_shiori@example.com
二宮 光	ninomiya_hikaru@example.com
石山 瞬	ishiyama_shun@example.com
花田 三郎	hanada_saburou@example.com
若槻 宏行	wakatsuki_hiroyuki@example.com
阿久津 博之	akutsu_hiroyuki@example.com
伊沢 六郎	izawa_rokurou@example.com
村上 砂羽	murakami_sawa@example.com
岩沢 咲	iwasawa_saki@example.com
牧 由宇	maki_yuu@example.com
若槻 徹平	wakatsuki_teppei@example.com
小峰 夏空	komine_sora@example.com
津川 育二	tsugawa_ikuji@example.com
石本 まさみ	ishimoto_masami@example.com
福井 草太	fukui_souta@example.com
金子 季衣	kaneko_toshie@example.com
西本 瞬	nishimoto_shun@example.com
江川 真悠子	egawa_mayuko@example.com
工藤 碧海	kudou_ouga@example.com
今 基祐	ima_kisuke@example.com
深沢 ひろみ	fukazawa_hiromi@example.com
富山 基祐	tomiyama_kisuke@example.com
山田 寿明	yamada_toshiaki@example.com
植松 俊二	uematsu_shunji@example.com
麻生 美佐子	asou_misako@example.com
柄本 了	emoto_ryou@example.com
大島 英嗣	ooshima_hidetsugu@example.com
細川 さとみ	hosokawa_satomi@example.com
浅田 雅彦	asada_masahiko@example.com
五大 夏希	godai_natsuki@example.com
瀬尾 恵望子	seo_emiko@example.com
石井 大五郎	ishii_daigorou@example.com
高野 寛治	takano_kanji@example.com
菅澤 寿々花	sugasawa_suzuka@example.com
村瀬 照生	murase_teruo@example.com
川辺 さとみ	kawabe_satomi@example.com
山上 啓介	yamagami_keisuke@example.com
三井 愛子	mitsui_aiko@example.com
庄司 克実	shouji_katsumi@example.com
松村 隆太	matsumura_ryuuta@example.com
藤井 一徳	fujii_ittoku@example.com
津田 みき	tsuda_miki1@example.com
富岡 研二	tomioka_kenji@example.com
片桐 奈月	katagiri_natsuki@example.com
寺井 憲一	terai_kenichi@example.com
岡本 晋也	okamoto_shinya@example.com
柴崎 翔子	shibazaki_shouko@example.com
島村 将也	shimamura_masaya@example.com
大竹 俊二	ootake_shunji@example.com
村岡 璃子	muraoka_riko@example.com
中田 光良	nakata_teruyoshi@example.com
仲田 七世	nakata_nanase@example.com
河内 惇	kawauchi_atsushi@example.com
出口 美幸	deguchi_miyuki@example.com
橋口 芽以	hashiguchi_mei@example.com
浜野 蒼甫	hamano_sousuke@example.com
玉木 染五郎	tamaki_somegorou@example.com
水川 友以乃	mizukawa_yuino@example.com
矢部 勇太	yabe_yuuta@example.com
井村 貴美子	imura_kimiko@example.com
米倉 洋介	yonekura_yousuke@example.com
甲斐 那奈	kai_nana@example.com
堀井 和久	horii_kazuhisa@example.com
野沢 浩太郎	nozawa_koutarou@example.com
森下 莉沙	morishita_risa@example.com
長崎 満	nagasaki_mitsuru@example.com
秋山 晋也	akiyama_shinya@example.com
越智 マサカズ	ochi_masakazu@example.com
石倉 明慶	ishikura_akiyoshi@example.com
山中 まさし	yamanaka_masashi@example.com
中原 知世	nakahara_chise@example.com
水口 研二	mizuguchi_kenji@example.com
若松 秀樹	wakamatsu_hideki@example.com
保坂 麻由子	hosaka_mayuko@example.com
大津 一	ootsu_hajime@example.com
藤田 隼士	fujita_shunji@example.com
小高 耕司	kodaka_kouji@example.com
川辺 啓介	kawabe_keisuke@example.com
岡田 麗奈	okada_rena@example.com
遠山 三省	tooyama_sansei@example.com
平井 季衣	hirai_toshie@example.com
松田 なつみ	matsuda_natsumi@example.com
小口 ひとみ	oguchi_hitomi@example.com
市田 あい	ichida_ai@example.com
深井 妃里	fukai_yuri@example.com
中川 敏和	nakagawa_toshikazu@example.com
岡山 あさみ	okayama_asami@example.com
少路 朝陽	shouji_asahi@example.com
手島 悟志	tejima_satoshi@example.com
新村 ジローラモ	niimura_girolamo@example.com
高村 花緑	takamura_karoku@example.com
おかやま 良介	okayama_ryousuke@example.com
ト字 優	toji_yuu@example.com
小田 明慶	oda_akiyoshi@example.com
宮川 寛	miyakawa_hiroshi@example.com
永瀬 浩正	nagase_hiromasa@example.com
比嘉 人志	hiyoshi_hitoshi@example.com
大和田 咲	oowada_saki@example.com
藤沢 愛梨	fujisawa_airi@example.com
大山 礼子	ooyama_reiko@example.com
対馬 恵子	tsushima_keiko@example.com
堀 だん吉	hori_dankichi@example.com
小森 あおい	komori_aoi@example.com
内村 竜次	uchimura_ryuuji@example.com
中岡 徹	nakaoka_tooru@example.com
木内 聖陽	kiuchi_masaaki@example.com
永島 光	nagashima_hikaru@example.com
佐藤 由宇	satou_yuu@example.com
平山 惇	hirayama_atsushi@example.com
上山 雅彦	kamiyama_masahiko@example.com
村中 浩介	muranaka_kousuke@example.com
根本 里奈	nemoto_rina@example.com
中川 知世	nakagawa_chise@example.com
島袋 満	shimabukuro_mitsuru@example.com
小野 小雁	ono_kogan@example.com
堀口 雅彦	horiguchi_masahiko@example.com
江藤 奈央	etou_nao@example.com
氏家 美和子	ujiie_miwako@example.com
岩沢 美嘉	iwasawa_mika@example.com
村山 ノブヒコ	murayama_nobuhiko@example.com
門田 翔	kadota_shou@example.com
阪口 遥	sakaguchi_haruka@example.com
神野 草太	kamino_souta@example.com
百瀬 徹平	momose_teppei@example.com
柳沢 恵子	yanagisawa_keiko@example.com
織田 明宏	oda_akihiro@example.com
野上 翔	nogami_shou@example.com
松元 克実	matsumoto_katsumi@example.com
豊島 みあ	toyoshima_mia@example.com
今 法子	kon_noriko@example.com
小杉 洋介	kosugi_yousuke@example.com
田中 圭	tanaka_kei@example.com
神崎 由美子	kanzaki_yumiko@example.com
江崎 幸子	ezaki_sachiko@example.com
田淵 明	tabuchi_akira@example.com
松野 獅童	matsuno_shidou@example.com
柳 ジローラモ	yanagi_girolamo@example.com
五大 そら	godai_sora@example.com
山形 隆博	yamagata_takahiro@example.com
坂東 麻緒	banntou_mao@example.com
星 真帆	hoshi_maho@example.com
赤松 瑠璃亜	akamatsu_ruria@example.com
西岡 希	nishioka_nozomi@example.com
北条 丈史	houjou_takeshi@example.com
大竹 美佐	ootake_misa@example.com
長田 えみ	nagata_emi@example.com
矢島 聖陽	yajima_masaaki@example.com
片瀬 菜々美	katase_nanami@example.com
増井 小雁	masui_kogan@example.com
白川 那奈	shirakawa_nana@example.com
須藤 蒼甫	sudou_sousuke@example.com
堀口 さやか	horiguchi_sayaka@example.com
山形 奈央	yamagata_nao@example.com
井上 裕司	inoue_yuuji@example.com
野島 薫	nojima_kaoru@example.com
柳川 良介	yanagawa_ryousuke@example.com
花田 郁恵	hanada_ikue@example.com
萩原 杏	hagiwara_ann@example.com
土井 充則	doi_mitsunori@example.com
山城 瞬	yamashiro_shun@example.com
小池 憲史	koike_norihito@example.com
中谷 華子	nakatani_hanako@example.com
松居 健	matsui_ken@example.com
内山 仁	uchiyama_jin@example.com
富樫 咲	togashi_saki@example.com
内村 智花	uchimura_tomoka@example.com
寺西 康文	teranishi_yasufumi@example.com
中尾 満	nakao_mitsuru@example.com
富沢 奈月	tomisawa_natsuki@example.com
神戸 豊	koube_yutaka@example.com
津田 育子	tsuda_ikuko@example.com
富沢 華子	tomisawa_hanako@example.com
浜 なぎさ	hama_nagisa@example.com
平尾 三省	hirao_sansei@example.com
小野 莉沙	ono_risa@example.com
山形 隆博	yamagata_takahiro1@example.com
石原 友香	ishihara_tomoka@example.com
森山 了	moriyama_ryou@example.com
大塚 ケンイチ	ootsuka_kenichi@example.com
徳重 徹	tokushige_tooru@example.com
瀬戸 康文	seto_yasufumi@example.com
安斎 景子	annzai_keiko@example.com
金丸 サダヲ	kanamaru_sadawo@example.com
大内 あおい	oouchi_aoi@example.com
吉川 那奈	kikkawa_nana@example.com
五十嵐 そら	igarashi_sora@example.com
矢島 まなみ	yajima_manami@example.com
島村 明宏	shimamura_akihiro@example.com
平野 だん吉	hirano_dankichi@example.com
草村 隆博	kusamura_takahiro@example.com
細川 幸子	hosokawa_sachiko@example.com
米沢 康文	yonezawa_yasufumi@example.com
黒木 友香	kuroki_tomoka@example.com
黒崎 染五郎	kurosaki_somegorou@example.com
川畑 華子	kawahata_hanako@example.com
神崎 真吾	kannzaki_shingo@example.com
飯野 哲平	iino_teppei@example.com
柴田 莉沙	shibata_risa@example.com
西川 薫	nishikawa_kaoru@example.com
木原 雅功	kihara_masatoshi@example.com
山内 美幸	yamanouchi_miyuki@example.com
関口 璃子	sekiguchi_riko@example.com
深田 那奈	fukada_nana@example.com
加藤 美優	katou_myuu@example.com
小野田 希	onoda_nozomi@example.com
滝本 だん吉	takimoto_dankichi@example.com
紺野 真一	konnno_shinichi@example.com
大平 啓介	oohira_keisuke@example.com
加藤 一恵	katou_kadue@example.com
植木 里穂	ueki_riho@example.com
秋元 サンタマリア	akimoto_stmaria@example.com
劇団 奈月	gekidan_natsuki@example.com
栗林 一代	kuribayashi_kazuyo@example.com
津田 優	tsuda_yuu@example.com
谷本 寛	tanimoto_hiroshi@example.com
佐々木 扶樹	sasaki_motoki@example.com
小町 雅彦	komachi_masahiko@example.com
矢沢 景子	yazawa_keiko@example.com
中島 詩織	nakajima_shiori@example.com
三好 裕次郎	miyoshi_yuujirou@example.com
小笠原 光臣	ogasawara_mitsuomi@example.com
深田 遥	fukada_haruka@example.com
宮島 克実	miyajima_katsumi@example.com
岩谷 優	iwatani_yuu@example.com
大江 真一	ooe_shinichi@example.com
生瀬 麻緒	namase_mao@example.com
石垣 愛梨	ishigaki_airi@example.com
河原 美咲	kawahara_misaki@example.com
八木 賢二	yagi_kenji@example.com
大泉 フミヤ	ooizumi_fumiya@example.com
海音寺 貴美子	kaionji_kimiko@example.com
中原 草太	nakahara_souta@example.com
緒形 慢太郎	ogata_mantarou@example.com
志水 美菜	shimizu_mina@example.com
西村 美月	nishimura_miduki@example.com
上田 雅之	ueda_masayuki@example.com
豊田 ケンイチ	toyota_kenichi@example.com
柳家 美佐	yanagiya_misa@example.com
塩見 あき	shiomi_aki@example.com
森岡 あおい	morioka_aoi@example.com
五味 友香	gomi_tomoka@example.com
熊沢 景子	kumasawa_keiko@example.com
古川 ノブヒコ	furukawa_nobuhiko@example.com
熊倉 なつみ	kumakura_natsumi@example.com
萩原 育子	hagiwara_ikuko@example.com
武藤 洋	mutou_you@example.com
植木 彩	ueki_aya@example.com
大川 敏也	ookawa_toshiya@example.com
加藤 綾女	katou_ayame@example.com
金谷 結衣	kanaya_yui@example.com
多岐川 将也	takigawa_masaya@example.com
土井 路子	doi_michiko@example.com
石井 優	ishii_yuu@example.com
赤松 七世	akamatsu_nanase@example.com
津川 結衣	tsugawa_yui@example.com
茂木 サンタマリア	mogi_stmaria@example.com
磯部 豊	isobe_yutaka@example.com
中村 麗奈	nakamura_rena@example.com
小西 大	konishi_masaru@example.com
大地 正義	oochi_masayoshi@example.com
鹿手袋 愛	shikatebukuro_ai@example.com
東 里穂	higashi_riho@example.com
石原 恵梨香	ishihara_erika@example.com
松山 友香	matsuyama_tomoka@example.com
川島 未來	kawashima_mirai@example.com
三木 美和子	miki_miwako@example.com
成海 なぎさ	narumi_nagisa@example.com
多田 美佐子	tada_misako@example.com
小出 一輝	koide_kazuki@example.com
池内 勇	ikeuchi_yuu1@example.com
栗田 えみ	kurita_emi@example.com
釈 真悠子	shaku_mayuko@example.com
福本 詩織	fukumoto_shiori@example.com
緒形 瞬	ogata_shun@example.com
久保田 正義	kubota_masayoshi@example.com
安田 郁恵	yasuda_ikue@example.com
桑田 亮	kuwata_ryou@example.com
長瀬 寿々花	nagase_suzuka@example.com
三浦 メイサ	miura_meisa@example.com
大谷 真帆	ootani_maho@example.com
藤森 豊	fujimori_yutaka@example.com
植村 勤	uemura_tsutomu@example.com
玉木 光臣	tamaki_mitsuomi@example.com
奥村 賢二	okumura_kenji@example.com
安 理紗	yasu_risa@example.com
浅沼 なつみ	asanuma_natsumi@example.com
藤野 利夫	fujino_toshio@example.com
城田 祐一	shirota_yuuichi@example.com
飯田 早織	iida_saori@example.com
今西 ケンイチ	imanishi_kenichi@example.com
生瀬 たかお	namase_takao@example.com
対馬 育二	tsushima_ikuji@example.com
明石 早織	akashi_saori@example.com
長谷 禄郎	nagaya_rokurou@example.com
平松 浩太郎	hiramatsu_koutarou@example.com
小笠原 ひとり	ogasawara_hitori@example.com
相馬 景子	aiba_keiko@example.com
上村 景子	uemura_keiko@example.com
樋口 守	higuchi_mamoru@example.com
小林 文世	kobayashi_fumiyo@example.com
岩田 栄一	iwata_eiichi@example.com
川口 愛	kawaguchi_ai@example.com
大谷 雅彦	ootani_masahiko@example.com
上杉 一	uesugi_hajime@example.com
藤 豊	fuji_yutaka@example.com
篠原 直人	shinohara_naoto@example.com
山上 ジョージ	yamagami_george@example.com
小杉 理紗	kosugi_risa@example.com
日下部 優	kusakabe_yuu@example.com
増田 さやか	masuda_sayaka@example.com
綾瀬 孝太郎	ayase_koutarou@example.com
吉沢 勤	yoshizawa_tsutomu@example.com
浜田 瞬	hamada_shun@example.com
沢尻 美月	sawajiri_miduki@example.com
高畑 遥	takahata_haruka@example.com
水田 結衣	mizuta_yui@example.com
花岡 染五郎	hanaoka_somegorou@example.com
小坂 文世	kozaka_fumiyo@example.com
伊藤 真奈美	itou_manami@example.com
佐川 美智子	sagawa_michiko@example.com
梅沢 聡	umezawa_satoshi@example.com
内村 ヒロ	uchimura_hiro@example.com
上原 高史	uehara_takashi@example.com
平田 雅彦	hirata_masahiko@example.com
板垣 明慶	itagaki_akiyoshi@example.com
宇都宮 悟志	utsunomiya_satoshi@example.com
熊沢 沙耶	kumasawa_saya@example.com
福原 米蔵	fukuhara_yonezou@example.com
小田 功補	oda_kousuke@example.com
八木 育子	yagi_ikuko@example.com
上杉 秀隆	uesugi_hidetaka@example.com
三枝 啓介	sannshi_keisuke@example.com
岡崎 恵子	okazaki_keiko@example.com
坂本 拓郎	sakamoto_takurou@example.com
大滝 まさし	ootaki_masashi@example.com
関 洋	seki_you@example.com
塩田 哲平	shiota_teppei@example.com
川島 真希	kawashima_maki@example.com
山西 エリカ	yamanishi_erika@example.com
野本 真帆	nomoto_maho@example.com
鶴田 なつみ	tsuruta_natsumi@example.com
貫地谷 まさみ	kanjiya_masami@example.com
日下 健	hinoshita_ken@example.com
徳田 一	tokuta_hajime@example.com
浜 りえ	hama_rie@example.com
有田 彩華	arita_ayaka@example.com
板倉 俊二	itakura_shunji@example.com
長谷川 功補	hasegawa_kousuke@example.com
後藤 寛治	gotou_kanji@example.com
関 礼子	seki_reiko@example.com
細野 優	hosono_yuu@example.com
山岸 慎之介	yamagishi_shinnosuke@example.com
河原 紗季	kawahara_saki@example.com
菅原 愛菜	sugawara_aina@example.com
大後 優一	oogo_yuuichi@example.com
藤川 明慶	fujikawa_akiyoshi@example.com
松沢 沙知絵	matsuzawa_sachie@example.com
新井 良介	arai_ryousuke@example.com
立花 良介	tachibana_ryousuke@example.com
岡野 貴美子	okano_kimiko@example.com
井田 恵梨香	ida_erika@example.com
窪塚 莉緒	kuboduka_rio@example.com
石山 愛子	ishiyama_aiko@example.com
宮部 ヒロ	miyabe_hiro@example.com
美木 奈月	miki_natsuki@example.com
寺田 剛基	terada_yoshiki@example.com
吹石 翔子	fukiishi_shouko@example.com
はしの 寿々花	hashino_suzuka@example.com
岡野 隆博	okano_takahiro@example.com
麻生 正義	asou_masayoshi@example.com
小畑 浩介	obata_kousuke@example.com
山上 奈々	yamagami_nana@example.com
神野 芳正	kamino_yoshimasa@example.com
小野田 直人	onoda_naoto@example.com
瀬戸 なぎさ	seto_nagisa@example.com
岩佐 さんま	iwasa_sanma@example.com
長田 聡	nagata_satoshi@example.com
岡村 さんま	okamura_sanma@example.com
赤羽 美和子	akabane_miwako@example.com
大山 くるみ	ooyama_kurumi@example.com
野村 蒼甫	nomura_sousuke@example.com
松澤 あい	matsuzawa_ai@example.com
高岡 晃司	takaoka_kouji@example.com
奥村 ひろ子	okumura_hiroko@example.com
島崎 まさみ	shimazaki_masami@example.com
北田 莉央	kitada_rio@example.com
清水 寿々花	shimizu_suzuka@example.com
七瀬 光博	nanase_mitsuhiro@example.com
細川 優	hosokawa_yuu@example.com
木下 杏	kinoshita_ann@example.com
豊島 真希	toyoshima_maki@example.com
渡部 一	watabe_hajime@example.com
岡本 寛治	okamoto_kanji@example.com
城田 慶二	shirota_keiji@example.com
難波 知世	nannba_chise@example.com
杉浦 真悠子	sugiura_mayuko@example.com
那須 大五郎	nasu_daigorou@example.com
緒方 隆之介	ogata_ryuunosuke@example.com
荒井 優	arai_yuu@example.com
井口 真悠子	iguchi_mayuko@example.com
牧野 サンタマリア	makino_stmaria@example.com
三村 まさみ	mimura_masami@example.com
高岡 誠一	takaoka_seiichi@example.com
寺脇 愛菜	terawaki_aina@example.com
藤沢 恵梨香	fujisawa_erika@example.com
宮野 春樹	miyano_haruki@example.com
森 なつみ	mori_natsumi@example.com
杉浦 哲平	sugiura_teppei@example.com
脇田 勤	wakita_tsutomu@example.com
貫地谷 敏和	kanjiya_toshikazu@example.com
竹中 弘也	takenaka_hironari@example.com
横田 璃子	yokota_riko@example.com
木田 真吾	kida_shingo@example.com
植村 茂樹	uemura_shigeki@example.com
坂田 れいな	sakata_reina@example.com
有田 直人	arita_naoto@example.com
布施 ひろみ	fuse_hiromi@example.com
林 竜次	hayashi_ryuuji@example.com
浅井 陽子	asai_youko@example.com
緒形 未來	ogata_mirai@example.com
中 草太	naka_souta@example.com
石倉 有起哉	ishikura_yukiya@example.com
平 雄太	taira_yuuta@example.com
根岸 功補	negishi_kousuke@example.com
佐々木 朝陽	sasaki_asahi@example.com
紺野 光臣	konno_mitsuomi@example.com
内村 瞬	uchimura_shun@example.com
近藤 鉄二	konndou_tetsuji@example.com
水谷 憲史	mizutani_norihito@example.com
塚原 明宏	tsukahara_akihiro@example.com
門田 そら	kadota_sora@example.com
澤田 杏	sawada_ann@example.com
高見 明宏	takami_akihiro@example.com
岩瀬 里奈	iwase_rina@example.com
小堀 雅彦	kohori_masahiko@example.com
浅沼 洋介	asanuma_yousuke@example.com
杉本 洋介	sugimoto_yousuke@example.com
関根 杏	sekine_ann@example.com
永野 ヒロ	nagano_hiro@example.com
柴田 七世	shibata_nanase@example.com
根本 窈	nemoto_you@example.com
小松 達士	komatsu_tatsuhito@example.com
北村 精児	kitamura_seiji@example.com
前田 さやか	maeda_sayaka@example.com
竹内 六郎	takeuchi_rokurou@example.com
中園 光洋	nakazono_mitsuhiro@example.com
田口 京子	taguchi_kyouko@example.com
川村 慶太	kawamura_keita@example.com
根岸 瞬	negishi_shun@example.com
平沢 奈月	hirasawa_natsuki@example.com
黒谷 未來	kurotani_mirai@example.com
大森 あさみ	oomori_asami@example.com
宇都宮 未來	utsunomiya_mirai@example.com
森山 賢二	moriyama_kenji@example.com
山中 愛子	yamanaka_aiko@example.com
川村 綾女	kawamura_ayame@example.com
本上 竜也	honjo_tatsuya@example.com
浅田 敏也	asada_toshiya@example.com
安藤 草太	ando_souta@example.com
内山 弘也	uchiyama_hironari@example.com
松岡 孝太郎	matsuoka_koutarou@example.com
井上 しほり	inoue_shihori@example.com
楠 華子	kusunoki_hanako@example.com
溝口 秀隆	mizoguchi_hidetaka@example.com
徳永 光	tokunaga_hikaru@example.com
境 大樹	sakai_hiroki@example.com
中原 メイサ	nakahara_meisa@example.com
石田 聡	ishida_satoshi@example.com
清野 希	kiyono_nozomi@example.com
藤岡 大五郎	fujioka_daigorou@example.com
大友 洋介	ootomo_yousuke@example.com
石倉 正敏	ishikura_masatoshi@example.com
島村 智花	shimamura_tomoka@example.com
楠本 充則	kusumoto_mitsunori@example.com
佐古 あさみ	sako_asami@example.com
石山 さゆり	ishiyama_sayuri@example.com
大熊 美幸	ookuma_miyuki@example.com
門田 美優	kadota_myuu@example.com
池田 竜也	ikeda_tatsuya@example.com
成瀬 豊	naruse_yutaka@example.com
田村 信吾	tamura_shingo@example.com
青木 有起哉	aoki_yukiya@example.com
中川 徹	nakagawa_tohru@example.com
成瀬 ちえみ	naruse_chiemi@example.com
小田 知世	oda_chise@example.com
岡山 丈雄	okayama_takeo@example.com
磯野 美佐子	isono_misako@example.com
鈴木 だん吉	suzuki_dankichi@example.com
中村 寛治	nakamura_kanji@example.com
日野 真帆	hino_maho@example.com
平林 エリカ	hirabayashi_erika@example.com
安田 育二	yasuda_ikuji@example.com
松島 満	matsushima_mitsuru@example.com
平山 恵子	hirayama_keiko@example.com
田畑 豊	tabata_yutaka@example.com
手島 あさみ	tejima_asami@example.com
安藤 エリカ	ando_erika@example.com
細山 由美子	hosoyama_yumiko@example.com
田辺 貴美子	tanabe_kimiko@example.com
深田 耕司	fukada_kouji@example.com
並木 明宏	namiki_akihiro@example.com
神谷 竜也	kamiya_tatsuya@example.com
西島 隆博	nishijima_takahiro@example.com
百瀬 知世	momose_chise@example.com
相原 杏	aihara_ann@example.com
栗山 真帆	kuriyama_maho@example.com
及川 真吾	oikawa_shingo@example.com
笹川 真悠子	sasagawa_mayuko@example.com
織田 ヒロ	oda_hiro@example.com
和田 浩介	wada_kousuke@example.com
結城 明宏	yuuki_akihiro@example.com
米谷 真吾	yoneya_shingo@example.com
松崎 恵美	matsuzaki_megumi@example.com
安斎 鉄二	annzai_tetsuji@example.com
奥田 景子	okuda_keiko@example.com
高瀬 樹里	takase_juri@example.com
奥田 ヒロ	okuda_hiro@example.com
久保田 めぐみ	kubota_megumi@example.com
山本 雅彦	yamamoto_masahiko@example.com
服部 染五郎	hattori_somegorou@example.com
牧瀬 たまき	makise_tamaki@example.com
水田 サダヲ	mizuta_sadawo@example.com
神木 はじめ	kamiki_hajime@example.com
久保田 満	kubota_mitsuru@example.com
小町 仁	komachi_jin@example.com
本橋 美幸	motohashi_miyuki@example.com
谷口 美幸	taniguchi_miyuki@example.com
田畑 礼子	tabata_reiko@example.com
福地 一樹	fukuchi_kazuki@example.com
大浦 ひろみ	ooura_hiromi@example.com
石塚 沙知絵	ishiduka_sachie@example.com
畑 拓郎	hatake_takurou@example.com
篠山 奈央	shinoyama_nao@example.com
坪井 陽子	tsuboi_youko@example.com
岩瀬 寛治	iwase_kanji@example.com
橋口 弘也	hashiguchi_hironari@example.com
竹内 美優	takeuchi_myuu@example.com
上野 瞬	ueno_shun@example.com
田中 美幸	tanaka_miyuki@example.com
町田 良介	machida_ryousuke@example.com
高木 勇	takagi_yuu@example.com
小木 聖陽	ogi_masaaki@example.com
宮野 詩織	miyano_shiori@example.com
竹中 美智子	takenaka_michiko@example.com
奥村 知世	okumura_chise@example.com
田畑 みあ	tabata_mia@example.com
小野田 秀樹	onoda_hideki@example.com
長沢 ノブヒコ	nagasawa_nobuhiko@example.com
清田 博明	kiyota_hiroaki@example.com
小峰 結衣	komine_yui@example.com
沢田 はるか	sawada_haruka@example.com
小平 サダヲ	kohira_sadawo@example.com
正木 孝太郎	masaki_koutarou@example.com
栗田 寛	kurita_hiroshi@example.com
奥 新太	oku_arata@example.com
長谷 紗季	nagaya_saki@example.com
若林 英嗣	wakabayashi_hidetsugu@example.com
津田 草太	tsuda_souta@example.com
森岡 咲	morioka_saki@example.com
金児 碧海	kaneko_ouga@example.com
小杉 ヒロ	kosugi_hiro@example.com
長谷川 友也	hasegawa_tomoya@example.com
赤羽 優	akabane_yuu@example.com
安藤 広司	anndou_kouji@example.com
堀 咲	hori_saki@example.com
奥貫 慢太郎	okunuki_mantarou@example.com
重松 ひろ子	shigematsu_hiroko@example.com
小田島 智花	odajima_tomoka@example.com
相原 聡	aihara_satoshi@example.com
田端 美優	tabata_myuu@example.com
大竹 窈	ootake_you@example.com
村松 恵子	muramatsu_keiko@example.com
菅野 貴美子	kanno_kimiko@example.com
相沢 将也	aizawa_masaya@example.com
森口 丈雄	moriguchi_takeo@example.com
小町 みゆき	komachi_miyuki@example.com
河内 公顕	kawauchi_kimiaki@example.com
西岡 康文	nishioka_yasufumi@example.com
菅原 美希	sugawara_miki@example.com
滝田 淳	takita_atsushi@example.com
早川 まさみ	hayakawa_masami@example.com
日下 夏希	hinoshita_natsuki@example.com
塚田 えみ	tsukada_emi@example.com
近藤 マサカズ	konndou_masakazu@example.com
沢井 郁恵	sawai_ikue@example.com
内海 瞬	uchimi_shun@example.com
永山 季衣	nagayama_toshie@example.com
上原 璃奈子	uehara_rinako@example.com
横山 郁恵	yokoyama_ikue@example.com
西脇 ヒロ	nishiwaki_hiro@example.com
黄川田 大樹	kikawada_hiroki@example.com
野際 淳子	nogiwa_atsuko@example.com
八十田 砂羽	yasoda_sawa@example.com
吉岡 郁恵	yoshioka_ikue@example.com
窪塚 雅彦	kuboduka_masahiko@example.com
葛西 洋介	kasai_yousuke@example.com
高島 ジョージ	takashima_george@example.com
工藤 耕司	kudou_kouji@example.com
ユースケ 育二	yusuke_ikuji@example.com
小寺 美嘉	kodera_mika@example.com
唐沢 はじめ	karasawa_hajime@example.com
今泉 康文	imaizumi_yasufumi@example.com
新井 俊二	arai_shunji@example.com
川瀬 美幸	kawase_miyuki@example.com
津川 祐基	tsugawa_yuuki@example.com
山本 未來	yamamoto_mirai@example.com
上杉 雅彦	uesugi_masahiko@example.com
鈴木 竜也	suzuki_tatsuya@example.com
川端 亜希	kawabata_aki@example.com
波多野 マサカズ	hatano_masakazu@example.com
佐野 英嗣	sano_hidetsugu@example.com
水口 めぐみ	mizuguchi_megumi@example.com
佐藤 博明	satou_hiroaki@example.com
古賀 仁晶	koga_hiroaki@example.com
河合 京子	kawai_kyouko@example.com
深沢 ひとり	fukazawa_hitori@example.com
山上 愛梨	yamagami_airi@example.com
浜田 徹	hamada_tooru@example.com
川添 亮	kawazoe_ryou@example.com
小西 早織	konishi_saori@example.com
小坂 哲平	kozaka_teppei@example.com
村上 由樹	murakami_yuki@example.com
綾瀬 三郎	ayase_saburou@example.com
松居 由美子	matsui_yumiko@example.com
岡崎 禄郎	okazaki_rokurou@example.com
杉山 哲平	sugiyama_teppei@example.com
尾崎 理紗	ozaki_risa@example.com
峰 拓郎	mine_takurou@example.com
大矢 進	ooya_susumu@example.com
神戸 礼子	koube_reiko@example.com
村田 里穂	murata_riho@example.com
満島 正敏	mitsushima_masatoshi@example.com
杉野 勝久	sugino_katsuhisa@example.com
藤原 遥	fujiwara_haruka@example.com
大倉 コウ	ookura_kou@example.com
三田 早織	mita_saori@example.com
依田 はじめ	yorita_hajime@example.com
内村 玲那	uchimura_rena@example.com
村山 誠治	murayama_seiji@example.com
荒木 彩	araki_aya@example.com
武井 亮介	takei_ryousuke@example.com
田上 淳	taue_atsushi@example.com
森 高史	mori_takashi@example.com
北川 さとみ	kitakawa_satomi@example.com
倉田 洋介	kurata_yousuke@example.com
日下部 弘也	kusakabe_hironari@example.com
玉井 一輝	tamai_kazuki@example.com
重田 誠治	shigeta_seiji@example.com
森本 サンタマリア	morimoto_stmaria@example.com
海野 兼	umino_ken@example.com
岸 ひとり	kishi_hitori@example.com
角谷 崇史	kadotani_takashi@example.com
西原 雄太	nishihara_yuuta@example.com
柳 智花	yanagi_tomoka@example.com
黒岩 浩介	kuroiwa_kousuke@example.com
今 鉄二	ima_tetsuji@example.com
白鳥 晴臣	shiratori_haruomi@example.com
門田 綾女	kadota_ayame@example.com
保坂 圭	hosaka_kei@example.com
松野 仁晶	matsuno_hiroaki@example.com
佐藤 一恵	satou_kadue@example.com
比嘉 知世	hiyoshi_chise@example.com
岡本 恵子	okamoto_keiko@example.com
下村 淳	shimomura_atsushi@example.com
小出 まなみ	koide_manami@example.com
栗山 遥	kuriyama_haruka@example.com
神田 そら	kannda_sora@example.com
平良 まみ	hirara_mami@example.com
北村 夏希	kitamura_natsuki@example.com
さだ 倫子	sada_noriko@example.com
吉岡 サンタマリア	yoshioka_stmaria@example.com
難波 法子	nannba_noriko@example.com
松岡 晋也	matsuoka_shinya@example.com
氏家 さんま	ujiie_sanma@example.com
坂野 俊二	itano_shunji@example.com
高橋 彩	takahashi_aya@example.com
古川 亜希	furukawa_aki@example.com
町田 ケンイチ	machida_kenichi@example.com
小畑 恵望子	obata_emiko@example.com
宮坂 貴嶺	miyasaka_takane@example.com
大竹 沙知絵	ootake_sachie@example.com
広川 フミヤ	hirokawa_fumiya@example.com
宮内 瞬	miyauchi_shun@example.com
畠中 将也	hatanaka_masaya@example.com
志村 朝香	shimura_asaka@example.com
少路 詩織	shouji_shiori@example.com
松本 なつみ	matsumoto_natsumi@example.com
牧野 祐基	makino_yuuki@example.com
稲田 さとみ	inada_satomi@example.com
比嘉 亮	hiyoshi_ryou@example.com
毛利 さんま	mouri_sanma@example.com
久保田 知世	kubota_chise@example.com
岩井 ひかり	iwai_hikari@example.com
上山 信吾	kamiyama_shingo@example.com
村井 そら	murai_sora@example.com
越智 七世	ochi_nanase@example.com
矢沢 洋介	yazawa_yousuke@example.com
川中 俊二	kawanaka_shunji@example.com
川野 一樹	kawano_kazuki@example.com
荻原 光良	hagiwara_teruyoshi@example.com
西谷 寿明	nishiya_toshiaki@example.com
植村 みあ	uemura_mia@example.com
広瀬 正敏	hirose_masatoshi@example.com
水谷 紗季	mizutani_saki@example.com
村瀬 七世	murase_nanase@example.com
牧野 耕司	makino_kouji@example.com
川井 誠治	kawai_seiji@example.com
正木 璃奈子	masaki_rinako@example.com
宮崎 さゆり	miyazaki_sayuri@example.com
吉本 花緑	yoshimoto_karoku@example.com
後藤 みゆき	gotou_miyuki@example.com
本村 扶樹	honnmura_motoki@example.com
西井 理紗	nishii_risa@example.com
今川 有海	imagawa_ami@example.com
鶴岡 薫	tsuruoka_kaoru@example.com
野島 ひろみ	nojima_hiromi@example.com
上田 克実	ueda_katsumi@example.com
福士 はるか	fukushi_haruka@example.com
小泉 龍吉	koizumi_ryuukichi@example.com
田原 莉沙	tahara_risa@example.com
若林 美幸	wakabayashi_miyuki@example.com
海音寺 莉緒	kaionji_rio@example.com
竹内 晃司	takeuchi_kouji@example.com
志田 千夏	shida_chinatsu@example.com
市田 花緑	ichida_karoku@example.com
八田 季衣	yatsuda_toshie@example.com
金丸 翔子	kanamaru_shouko@example.com
塚田 直人	tsukada_naoto@example.com
西本 ひとみ	nishimoto_hitomi@example.com
野口 昴	noguchi_subaru@example.com
杉野 郁恵	sugino_ikue@example.com
長谷川 完爾	hasegawa_kanji@example.com
堀北 さんま	horikita_sanma@example.com
長瀬 達士	nagase_tatsuhito@example.com
堀 信吾	hori_shingo@example.com
梅津 光臣	umedu_mitsuomi@example.com
須賀 咲	suga_saki@example.com
柴崎 正敏	shibazaki_masatoshi@example.com
中根 七世	nakane_nanase@example.com
野沢 くるみ	nozawa_kurumi@example.com
田村 光博	tamura_mitsuhiro@example.com
菅原 瞳	sugawara_hitomi@example.com
奥村 明	okumura_akira@example.com
重田 芳正	shigeta_yoshimasa@example.com
竹内 ひとみ	takeuchi_hitomi@example.com
砂川 翔子	sunakawa_shouko@example.com
今野 聡	imano_satoshi@example.com
塩見 ノブヒコ	shiomi_nobuhiko@example.com
下山 淳	shimoyama_atsushi@example.com
堀 茂樹	hori_shigeki@example.com
板倉 早織	itakura_saori@example.com
秋元 昴	akimoto_subaru@example.com
小椋 ひかり	ogura_hikari@example.com
大久保 涼子	ookubo_ryouko@example.com
宮崎 鉄二	miyazaki_tetsuji@example.com
土谷 さやか	tsuchiya_sayaka@example.com
国分 恵美	kokubunn_megumi@example.com
金子 隆	kaneko_takashi@example.com
田島 まさし	tajima_masashi@example.com
石橋 恵麻	ishibashi_ema@example.com
本村 米蔵	honnmura_yonezou@example.com
小幡 しほり	obata_shihori@example.com
蒼井 ひろ子	aoi_hiroko@example.com
河内 正敏	kawauchi_masatoshi@example.com
山瀬 将也	yamase_masaya@example.com
鶴田 まさし	tsuruta_masashi@example.com
北原 さとみ	kitahara_satomi@example.com
益岡 ひかり	masuoka_hikari@example.com
坂本 かおり	sakamoto_kaori@example.com
永島 菊生	nagashima_kikuo@example.com
沖 恵梨香	oki_erika@example.com
竹中 南朋	takenaka_nao@example.com
西岡 ちえみ	nishioka_chiemi@example.com
松野 孝太郎	matsuno_koutarou@example.com
中村 さんま	nakamura_sanma@example.com
河合 雅彦	kawai_masahiko@example.com
比嘉 光	hiyoshi_hikaru@example.com
塩谷 サダヲ	shiotani_sadawo@example.com
黒木 恵梨香	kuroki_erika@example.com
浦野 さんま	urano_sanma@example.com
宮地 洋介	miyaji_yousuke@example.com
小山 法子	oyama_noriko@example.com
岡田 彩華	okada_ayaka@example.com
吉田 竜也	yoshida_tatsuya@example.com
植松 ノブヒコ	uematsu_nobuhiko@example.com
古田 誠一	furuta_seiichi@example.com
竹本 ひろ子	takemoto_hiroko@example.com
志水 彩華	shimizu_ayaka@example.com
奥村 法子	okumura_noriko@example.com
仲田 季衣	nakata_toshie@example.com
対馬 メイサ	tsushima_meisa@example.com
梅田 長利	umeda_nagatoshi@example.com
伴 育子	ban_ikuko@example.com
栗田 愛梨	kurita_airi@example.com
尾崎 真希	ozaki_maki@example.com
小野田 瞬	onoda_shun@example.com
木村 しぼり	kimura_shibori@example.com
横山 三郎	yokoyama_saburou@example.com
川野 はじめ	kawano_hajime@example.com
北島 なつみ	kitajima_natsumi@example.com
橋口 守	hashiguchi_mamoru@example.com
岩谷 美佳	iwatani_mika@example.com
細野 はじめ	hosono_hajime@example.com
中林 なつみ	nakabayashi_natsumi@example.com
内山 公顕	uchiyama_kimiaki@example.com
宮地 由樹	miyaji_yuki@example.com
鈴木 愛	suzuki_ai@example.com
中谷 恵梨香	nakatani_erika@example.com
日高 恵望子	hidaka_emiko@example.com
稲垣 亮	inagaki_ryou@example.com
奥野 南朋	okuno_nao@example.com
田淵 慢太郎	tabuchi_mantarou@example.com
岡部 ヒロ	okabe_hiro@example.com
川中 茂樹	kawanaka_shigeki@example.com
仲村 ケンイチ	nakamura_kenichi@example.com
栗林 聡	kuribayashi_satoshi@example.com
菅原 了	sugawara_ryou@example.com
難波 憲史	nannba_norihito@example.com
尾形 守	ogata_mamoru@example.com
北川 さんま	kitagawa_sanma@example.com
大河内 康文	ookouchi_yasufumi@example.com
三井 恵梨香	mitsui_erika@example.com
藤木 れいな	fujiki_reina@example.com
多田 美帆	tada_miho@example.com
小出 咲	koide_saki@example.com
田畑 さやか	tabata_sayaka@example.com
梅村 莉緒	umemura_rio@example.com
板橋 れいな	itabashi_reina@example.com
金城 智花	kanashiro_tomoka@example.com
河野 はるか	kawano_haruka@example.com
窪田 雅彦	kubota_masahiko@example.com
宮地 恵望子	miyaji_emiko@example.com
南部 綾女	nannbu_ayame@example.com
谷 優	tani_yuu@example.com
細野 敏也	hosono_toshiya@example.com
北条 春樹	houjou_haruki@example.com
志賀 敏也	shiga_toshiya@example.com
中島 有海	nakashima_ami@example.com
奥貫 ヒロ	okunuki_hiro@example.com
越智 有起哉	ochi_yukiya@example.com
伊丹 郁恵	itami_ikue@example.com
劇団 丈史	gekidan_takeshi@example.com
桑田 涼	kuwata_ryou1@example.com
小池 光博	koike_mitsuhiro@example.com
多岐川 窈	takigawa_you@example.com
松沢 季衣	matsuzawa_toshie1@example.com
坂口 一代	sakaguchi_kazuyo@example.com
安 友香	yasu_tomoka@example.com
金井 京子	kanai_kyouko@example.com
大久保 貴嶺	ookubo_takane@example.com
大井 育子	ooi_ikuko@example.com
島本 亮介	shimamoto_ryousuke@example.com
河原 優	kawahara_yuu@example.com
浅田 亜希	asada_aki@example.com
神戸 あや子	koube_ayako@example.com
細川 米蔵	hosokawa_yonezou@example.com
倉持 佑	kuramochi_tasuku@example.com
平井 一	hirai_hajime@example.com
横井 光博	yokoi_mitsuhiro@example.com
金山 勇太	kanayama_yuuta@example.com
浜 恵梨香	hama_erika@example.com
黒田 佑	kurota_tasuku@example.com
青山 理紗	aoyama_risa@example.com
酒井 竜次	sakai_ryuuji@example.com
高柳 桃子	takayanagi_momoko@example.com
長田 瞳	nagata_hitomi@example.com
少路 基祐	shouji_kisuke@example.com
おかやま 光博	okayama_mitsuhiro@example.com
児島 鉄二	kojima_tetsuji@example.com
角田 三省	kadota_sansei@example.com
児島 勇	kojima_yuu@example.com
小口 薫	oguchi_kaoru@example.com
三井 サンタマリア	mitsui_stmaria@example.com
大川 あや子	ookawa_ayako@example.com
川辺 高史	kawabe_takashi@example.com
奥田 美幸	okuda_miyuki@example.com
宮田 博之	miyata_hiroyuki@example.com
香川 さんま	kagawa_sanma@example.com
原田 一	harada_hajime@example.com
吉原 将也	yoshiwara_masaya@example.com
宇田川 雅彦	udagawa_masahiko@example.com
松谷 恵子	matsutani_keiko@example.com
大場 たまき	ooba_tamaki@example.com
赤坂 彩	akasaka_aya@example.com
井川 洋	igawa_you@example.com
大滝 サンタマリア	ootaki_stmaria@example.com
本上 徹平	honjo_teppei@example.com
水島 獅童	mizushima_shidou@example.com
浜口 さとみ	hamaguchi_satomi@example.com
野原 扶樹	nohara_motoki@example.com
麻生 惇	asou_jun@example.com
大河内 研二	ookouchi_kenji@example.com
戸塚 照生	toduka_teruo@example.com
志水 えみ	shimizu_emi@example.com
渡部 博明	watabe_hiroaki@example.com
大槻 晃司	ootsuki_kouji@example.com
児島 碧海	kojima_ouga@example.com
皆川 隆	minakawa_takashi@example.com
福島 獅童	fukushima_shidou@example.com
川島 たかお	kawashima_takao@example.com
金森 美希	kanamori_miki@example.com
田村 あおい	tamura_aoi@example.com
岸 俊二	kishi_shunji@example.com
今西 愛子	imanishi_aiko@example.com
生瀬 明日	namase_meibi@example.com
白井 明慶	shirai_akiyoshi@example.com
根本 結衣	nemoto_yui@example.com
小出 優一	koide_yuuichi@example.com
伊藤 右京	itou_ukyou@example.com
中尾 さやか	nakao_sayaka@example.com
松川 花	matsukawa_hana@example.com
金田 美幸	kaneda_miyuki@example.com
安斎 麻緒	annzai_mao@example.com
水野 由樹	mizuno_yuki1@example.com
川口 隆博	kawaguchi_takahiro@example.com
石丸 麻由子	ishimaru_mayuko@example.com
中島 照生	nakashima_teruo@example.com
進藤 雅彦	shinndou_masahiko@example.com
笹原 雅彦	sasahara_masahiko@example.com
内田 右京	uchida_ukyou@example.com
海音寺 結子	kaionji_yuuko@example.com
岡崎 陽子	okazaki_youko@example.com
堀江 孝太郎	horie_koutarou@example.com
多部 明日	tabe_meibi@example.com
金城 優一	kanashiro_yuuichi@example.com
小池 正義	koike_masayoshi@example.com
中沢 結衣	nakazawa_yui@example.com
中原 沙知絵	nakahara_sachie@example.com
大城 フミヤ	ooshiro_fumiya@example.com
綾瀬 幸平	ayase_kouhei@example.com
久保田 あおい	kubota_aoi@example.com
玉井 メイサ	tamai_meisa@example.com
江原 輝信	ehara_akinobu@example.com
塩谷 遥	shiotani_haruka@example.com
五十嵐 美菜	igarashi_mina@example.com
丸山 美佳	maruyama_mika@example.com
尾崎 扶樹	ozaki_motoki@example.com
染谷 晃司	someya_kouji@example.com
石田 賢治	ishida_kenji@example.com
浅井 美佐子	asai_misako@example.com
五十嵐 大樹	igarashi_hiroki@example.com
黒木 和之	kuroki_kazuyuki@example.com
池畑 竜次	ikehata_ryuuji@example.com
赤木 徹	akagi_tooru@example.com
奥村 草太	okumura_souta@example.com
山瀬 奈々	yamase_nana@example.com
平 麻由子	taira_mayuko@example.com
細山 ちえみ	hosoyama_chiemi@example.com
多岐川 菜摘	takigawa_natsumi@example.com
緒形 兼	ogata_ken@example.com
大和田 洋	oowada_you@example.com
中村 はるか	nakamura_haruka@example.com
桑田 直人	kuwata_naoto@example.com
市川 翔	ichikawa_shou@example.com
荒川 恵美	arakawa_megumi@example.com
菅澤 薫	sugasawa_kaoru@example.com
横井 杏	yokoi_ann@example.com
脇田 寛治	wakita_kanji@example.com
芦屋 博明	ashiya_hiroaki@example.com
志水 聡	shimizu_satoshi@example.com
三村 サンタマリア	mimura_stmaria@example.com
岡部 夏空	okabe_sora@example.com
深井 翔子	fukai_shouko@example.com
岡崎 輝信	okazaki_akinobu@example.com
城咲 洋介	shirosaki_yousuke@example.com
野口 エリカ	noguchi_erika@example.com
土谷 真一	tsuchiya_shinichi@example.com
堤 ひとり	tsutsumi_hitori@example.com
三橋 恵梨香	mihashi_erika@example.com
伊丹 涼	itami_ryou@example.com
笹川 しぼり	sasagawa_shibori@example.com
宇田川 隆	udagawa_takashi@example.com
小玉 兼	kodama_ken@example.com
山西 麗奈	yamanishi_rena@example.com
一青 友香	hitoto_tomoka@example.com
安倍 遥	abe_haruka@example.com
浅見 圭	asami_kei@example.com
牧 ちえみ	maki_chiemi@example.com
中原 美帆	nakahara_miho@example.com
吉崎 俊二	yoshizaki_shunji@example.com
富樫 沙耶	togashi_saya@example.com
黄川田 京子	kikawada_kyouko@example.com
山元 秀隆	yamamoto_hidetaka@example.com
宮崎 華子	miyazaki_hanako@example.com
相川 ひかり	aikawa_hikari@example.com
柴咲 真悠子	shibasaki_mayuko@example.com
新井 くるみ	arai_kurumi@example.com
阿井 英嗣	ai_hidetsugu@example.com
山内 礼子	yamauchi_reiko@example.com
横川 誠治	yokokawa_seiji@example.com
小野 隆博	ono_takahiro@example.com
笠原 莉緒	kasahara_rio@example.com
毛利 知世	mouri_chise@example.com
戸田 路子	toda_michiko@example.com
井本 恵梨香	imoto_erika@example.com
宇田川 里穂	udagawa_riho@example.com
野原 瞬	nohara_shun@example.com
落合 早紀	ochiai_saki@example.com
岡 優	oka_yuu@example.com
渡辺 三省	watanabe_sansei@example.com
中谷 輝信	nakatani_akinobu@example.com
大谷 裕次郎	ootani_yuujirou@example.com
高野 亮介	takano_ryousuke@example.com
新田 遥	arata_haruka@example.com
深沢 路子	fukazawa_michiko@example.com
栗田 惇	kurita_atsushi@example.com
中林 寛	nakabayashi_hiroshi@example.com
飯田 フミヤ	iida_fumiya@example.com
生田 翔太	namata_shouta@example.com
玉城 翔太	tamaki_shouta@example.com
益岡 南朋	masuoka_nao@example.com
滝口 明日	takiguchi_meibi@example.com
有馬 そら	arima_sora@example.com
関 莉緒	seki_rio@example.com
奥田 千佳子	okuda_chikako@example.com
日下 美月	hinoshita_miduki@example.com
益田 友以乃	masuda_yuino@example.com
中川 勇太	nakagawa_yuuta@example.com
奥田 早織	okuda_saori@example.com
板垣 優一	itagaki_yuuichi@example.com
木村 はじめ	kimura_hajime@example.com
秋元 綾女	akimoto_ayame@example.com
橘 信輔	tachibana_shinsuke@example.com
萩原 寛	hagiwara_hiroshi@example.com
川口 季衣	kawaguchi_toshie@example.com
清田 亮	kiyota_ryou@example.com
長島 憲史	nagashima_norihito@example.com
片岡 希	kataoka_nozomi@example.com
相沢 光	aizawa_hikaru@example.com
奥村 竜次	okumura_ryuuji@example.com
宮迫 淳	miyasako_atsushi@example.com
馬場 美帆	baba_miho1@example.com
大場 佳乃	ooba_yoshino@example.com
正木 ヒカル	masaki_hikaru@example.com
平林 杏	hirabayashi_ann@example.com
市田 敏和	ichida_toshikazu@example.com
河合 貴嶺	kawai_takane@example.com
西秋 あや子	nishiaki_ayako@example.com
町田 はるか	machida_haruka@example.com
増井 米蔵	masui_yonezou@example.com
門田 恵子	kadota_keiko@example.com
深沢 雅彦	fukazawa_masahiko@example.com
竹内 充則	takeuchi_mitsunori@example.com
井沢 一代	izawa_kazuyo@example.com
泉 真帆	izumi_maho@example.com
川中 和久	kawanaka_kazuhisa@example.com
小田 なぎさ	oda_nagisa@example.com
豊島 瞬	toyoshima_shun@example.com
大野 竜次	oono_ryuuji@example.com
星 兼	hoshi_ken@example.com
浜本 正敏	hamamoto_masatoshi@example.com
石野 隆	ishino_takashi@example.com
八木 克実	yagi_katsumi@example.com
中村 沙耶	nakamura_saya@example.com
湊 亮	minato_ryou@example.com
沖田 ひろ子	okita_hiroko@example.com
小林 鉄二	kobayashi_tetsuji@example.com
松澤 豊	matsuzawa_yutaka@example.com
石黒 亮	ishiguro_ryou@example.com
平川 大樹	hirakawa_hiroki@example.com
瀬尾 恵梨香	seo_erika@example.com
村田 路子	murata_michiko@example.com
矢作 優	yahagi_yuu@example.com
林田 朝陽	hayashida_asahi@example.com
酒井 孝太郎	sakai_koutarou@example.com
哀川 一樹	aikawa_kazuki@example.com
鈴木 恵子	suzuki_keiko@example.com
沢田 奈央	sawada_nao@example.com
桜井 知世	sakurai_chise@example.com
田原 サンタマリア	tahara_stmaria@example.com
吉崎 沙耶	yoshizaki_saya@example.com
古山 勇一	furuyama_yuuichi@example.com
伊藤 夏空	itou_sora@example.com
梅津 寛治	umedu_kanji@example.com
斎藤 明慶	saitou_akiyoshi@example.com
木戸 太朗	kido_tarou@example.com
戸塚 真帆	toduka_maho@example.com
岩本 みあ	iwamoto_mia@example.com
猪股 あい	inomata_ai@example.com
高松 碧海	takamatsu_ouga@example.com
沼田 咲	numata_saki@example.com
野村 昌代	nomura_masayo@example.com
河西 由宇	kawanishi_yuu@example.com
木田 沙知絵	kida_sachie@example.com
宮脇 薫	miyawaki_kaoru@example.com
小坂 あさみ	kozaka_asami@example.com
澤田 勝久	sawada_katsuhisa@example.com
園田 兼	sonoda_ken@example.com
水田 豊	mizuta_yutaka@example.com
柴山 隆之介	shibayama_ryuunosuke@example.com
本橋 まなみ	motohashi_manami@example.com
瀬尾 慎之介	seo_shinnosuke@example.com
新垣 サダヲ	niigaki_sadawo@example.com
三田 ひとり	mita_hitori@example.com
役所 涼	yakusho_ryou@example.com
劇団 はじめ	gekidan_hajime@example.com
福地 そら	fukuchi_sora@example.com
五十嵐 耕司	igarashi_kouji@example.com
片岡 慢太郎	kataoka_mantarou@example.com
今村 満	imamura_mitsuru@example.com
斉藤 真帆	saitou_maho@example.com
森岡 勇介	morioka_yuusuke@example.com
八木 あい	yagi_ai@example.com
有田 孝太郎	arita_koutarou@example.com
大高 妃里	oodaka_yuri@example.com
藤沢 礼子	fujisawa_reiko@example.com
パンツェッタ 恵美	panzetta_megumi@example.com
片瀬 亜希	katase_aki@example.com
畠山 さやか	hatayama_sayaka@example.com
飯野 れいな	iino_reina@example.com
津田 雅彦	tsuda_masahiko@example.com
大熊 ちえみ	ookuma_chiemi@example.com
金児 めぐみ	kaneko_megumi@example.com
神戸 友也	koube_tomoya@example.com
石坂 小百合	ishizaka_sayuri@example.com
遠藤 碧海	enndou_ouga@example.com
大島 郁恵	ooshima_ikue@example.com
照井 なぎさ	terui_nagisa@example.com
河野 真帆	kouno_maho@example.com
大谷 はるか	ootani_haruka@example.com
大和田 そら	oowada_sora@example.com
児島 惇	kojima_jun@example.com
高畑 はるみ	takabata_harumi@example.com
八木 杏	yagi_ann@example.com
今 直人	kon_naoto@example.com
山中 秀隆	yamanaka_hidetaka@example.com
浦野 満	urano_mitsuru@example.com
片岡 涼	kataoka_ryou@example.com
町田 貴美子	machida_kimiko@example.com
井川 大五郎	igawa_daigorou@example.com
山村 淳	yamamura_atsushi@example.com
近藤 真吾	konndou_shingo@example.com
松川 慶二	matsukawa_keiji@example.com
六角 陽子	rokkaku_youko@example.com
千田 未華子	sennda_mikako@example.com
対馬 隼士	tsushima_shunji@example.com
城戸 鉄二	kido_tetsuji@example.com
松本 杏	matsumoto_ann@example.com
中原 くるみ	nakahara_kurumi@example.com
片瀬 菜々美	katase_nanami1@example.com
片山 まひる	katayama_mahiru@example.com
磯村 太朗	isomura_tarou@example.com
窪田 隆之介	kubota_ryuunosuke@example.com
村瀬 佑	murase_tasuku@example.com
滝本 美月	takimoto_miduki@example.com
古屋 直人	furuya_naoto@example.com
百瀬 愛子	momose_aiko@example.com
羽田 龍吉	hada_ryuukichi@example.com
五味 めぐみ	gomi_megumi@example.com
梅沢 英嗣	umezawa_hidetsugu@example.com
桜井 遥	sakurai_haruka@example.com
河村 貴嶺	kawamura_takane@example.com
麻生 翔	asou_shou@example.com
神崎 祐一	kanzaki_yuuichi@example.com
平尾 啓介	hirao_keisuke@example.com
深田 公顕	fukada_kimiaki@example.com
高尾 一恵	takao_kadue@example.com
塩谷 昌代	shioya_masayo@example.com
重田 ヒロ	shigeta_hiro@example.com
大和田 京子	oowada_kyouko@example.com
竹原 あや子	takehara_ayako@example.com
中村 染五郎	nakamura_somegorou@example.com
大矢 健	ooya_ken@example.com
保坂 優	hosaka_yuu@example.com
田中 未華子	tanaka_mikako@example.com
小高 由美子	kodaka_yumiko@example.com
河野 淳	kouno_atsushi@example.com
安座間 耕司	azama_kouji@example.com
遠藤 麻由子	enndou_mayuko@example.com
児島 砂羽	kojima_sawa@example.com
奈良 知史	nara_tomofumi@example.com
北田 夏希	kitada_natsuki@example.com
蛍原 麻由子	hotohara_mayuko@example.com
藤崎 あさみ	fujisaki_asami@example.com
大熊 恵梨香	ookuma_erika@example.com
浅沼 南朋	asanuma_nao@example.com
福田 翔子	fukuda_shouko@example.com
高倉 亮	takakura_ryou@example.com
及川 聡	oikawa_satoshi@example.com
門脇 真一	kadowaki_shinichi@example.com
一青 茜	hitoto_akane@example.com
杉原 朝陽	sugihara_asahi@example.com
木下 亮	kinoshita_ryou@example.com
中原 広之	nakahara_hiroyuki@example.com
山野 真吾	yamano_shingo@example.com
早坂 美佐	hayasaka_misa@example.com
松尾 優	matsuo_yuu@example.com
栗原 法嗣	kurihara_houshi@example.com
青木 倫子	aoki_noriko@example.com
西 たかお	nishi_takao@example.com
武藤 悟志	mutou_satoshi@example.com
大平 怜奈	oohira_reina@example.com
梅津 豊	umedu_yutaka@example.com
細山 竜也	hosoyama_tatsuya@example.com
柳原 あい	yanagihara_ai@example.com
諏訪 一輝	suwa_kazuki@example.com
内藤 達士	naitou_tatsuhito@example.com
高橋 信輔	takahashi_shinsuke@example.com
足立 恵梨香	adachi_erika@example.com
保坂 大五郎	hosaka_daigorou@example.com
横山 鉄二	yokoyama_tetsuji@example.com
野際 美嘉	nogiwa_mika@example.com
横尾 晋也	yokoo_shinya@example.com
堀口 愛梨	horiguchi_airi@example.com
依田 美幸	yorita_miyuki@example.com
畑 直人	hatake_naoto@example.com
田畑 惇	tabata_atsushi@example.com
水谷 ヒロ	mizutani_hiro@example.com
荒木 大五郎	araki_daigorou@example.com
早川 一代	hayakawa_kazuyo@example.com
黄川田 智花	kikawada_tomoka@example.com
小野田 妃里	onoda_yuri@example.com
北沢 薫	kitazawa_kaoru@example.com
森永 憲史	morinaga_norihito@example.com
向井 陽子	murai_youko@example.com
葛西 恵梨香	kasai_erika@example.com
尾形 米蔵	ogata_yonezou@example.com
有田 美里	arita_miri@example.com
永野 季衣	nagano_toshie@example.com
大和 博之	yamato_hiroyuki@example.com
黒岩 功補	kuroiwa_kousuke1@example.com
島本 奈々	shimamoto_nana@example.com
岩田 薫	iwata_kaoru@example.com
武 将也	take_masaya@example.com
田村 礼子	tamura_reiko@example.com
新谷 陽子	araya_youko@example.com
石川 弘也	ishikawa_hironari@example.com
須藤 太朗	sudou_tarou@example.com
前島 恵麻	maejima_ema@example.com
黒川 祐基	kurokawa_yuuki@example.com
合田 照生	aida_teruo@example.com
大貫 育子	oonuki_ikuko@example.com
大和田 さやか	oowada_sayaka@example.com
佐々木 幸子	sasaki_sachiko@example.com
小菅 雅彦	kosuge_masahiko@example.com
相馬 竜也	aiba_tatsuya@example.com
宮崎 結子	miyazaki_yuuko@example.com
佐藤 耕司	satou_kouji@example.com
島村 聡	shimamura_satoshi@example.com
志田 法子	shida_noriko@example.com
河西 寛	kawanishi_hiroshi@example.com
武藤 公顕	mutou_kimiaki@example.com
小市 寛	koichi_hiroshi@example.com
須賀 育二	suga_ikuji@example.com
金山 妃里	kanayama_yuri@example.com
植村 陽子	uemura_youko@example.com
二宮 俊二	ninomiya_shunji@example.com
村岡 秀樹	muraoka_hideki@example.com
矢野 美佐子	yano_misako@example.com
山田 愛菜	yamada_aina@example.com
海音寺 遥	kaionji_haruka@example.com
三橋 七世	mihashi_nanase@example.com
吉田 進	yoshida_susumu@example.com
寺尾 莉央	terao_rio@example.com
野中 まなみ	nonaka_manami@example.com
永田 鉄洋	nagata_tetsuhiro@example.com
大熊 一代	ookuma_kazuyo@example.com
藤原 六郎	fujiwara_rokurou@example.com
本間 千佳子	honma_chikako@example.com
西脇 みき	nishiwaki_miki@example.com
大坪 慢太郎	ootsubo_mantarou@example.com
長野 直人	nagano_naoto@example.com
川西 隆	kawanishi_takashi@example.com
園田 奈々	sonoda_nana@example.com
津田 ひろみ	tsuda_hiromi@example.com
萩原 みゆき	hagiwara_miyuki@example.com
金丸 美佳	kanamaru_mika@example.com
亀山 遥	kameyama_haruka@example.com
黒谷 法子	kurotani_noriko@example.com
安部 雅之	abe_masayuki@example.com
柳川 新太	yanagawa_arata@example.com
山下 茂樹	yamashita_shigeki@example.com
大谷 めぐみ	ootani_megumi@example.com
西岡 完爾	nishioka_kanji@example.com
水谷 染五郎	mizutani_somegorou@example.com
樋口 紗季	higuchi_saki@example.com
飯田 康文	iida_yasufumi@example.com
菊地 洋	kikuchi_you@example.com
古田 佳乃	furuta_yoshino@example.com
飯島 聡	iijima_satoshi@example.com
小田 淳	oda_atsushi@example.com
森山 春樹	moriyama_haruki@example.com
大畑 はじめ	oohata_hajime@example.com
牧田 綾女	makita_ayame@example.com
北原 莉沙	kitahara_risa@example.com
武 きみまろ	take_kimimaro@example.com
宮崎 由樹	miyazaki_yuki@example.com
梅本 まなみ	umemoto_manami@example.com
大内 みあ	oouchi_mia@example.com
島袋 哲平	shimabukuro_teppei@example.com
川添 貴嶺	kawazoe_takane@example.com
門田 浩正	kadota_hiromasa@example.com
橘 晋也	tachibana_shinya@example.com
池内 はじめ	ikeuchi_hajime@example.com
深井 サンタマリア	fukai_stmaria@example.com
菅 雅彦	suga_masahiko@example.com
近藤 明	konndou_akira@example.com
山西 慶太	yamanishi_keita@example.com
安座間 智花	azama_tomoka@example.com
岡 瞳	oka_hitomi@example.com
木原 優	kihara_yuu@example.com
長岡 雅彦	nagaoka_masahiko@example.com
染谷 マサカズ	someya_masakazu@example.com
松崎 一代	matsuzaki_kazuyo@example.com
土田 まひる	tsuchida_mahiru@example.com
宮里 愛	miyazato_ai@example.com
細山 憲史	hosoyama_norihito@example.com
金城 真吾	kanashiro_shingo@example.com
恩田 ひとり	onnda_hitori@example.com
山上 璃奈子	yamagami_rinako@example.com
米谷 七世	yoneya_nanase@example.com
合田 まみ	aida_mami@example.com
杉村 夏希	sugimura_natsuki@example.com
杉村 綾女	sugimura_ayame@example.com
早坂 ジローラモ	hayasaka_girolamo@example.com
池上 竜次	ikegami_ryuuji@example.com
橋本 雅之	hashimoto_masayuki@example.com
小沢 遥	ozawa_haruka@example.com
半田 美和子	hannda_miwako@example.com
白石 大樹	shiraishi_hiroki@example.com
北島 恵梨香	kitajima_erika@example.com
小池 れいな	koike_reina@example.com
志賀 幸平	shiga_kouhei@example.com
吉崎 良介	yoshizaki_ryousuke@example.com
武井 光洋	takei_mitsuhiro1@example.com
片山 沙知絵	katayama_sachie@example.com
武田 未來	takeda_mirai@example.com
平塚 美帆	hiratsuka_miho@example.com
松本 涼	matsumoto_ryou@example.com
瀬戸内 景子	setouchi_keiko@example.com
工藤 玲那	kudou_rena@example.com
磯部 洋介	isobe_yousuke@example.com
小西 理紗	konishi_risa@example.com
中本 薫	nakamoto_kaoru@example.com
久野 那奈	hisano_nana@example.com
小沼 めぐみ	konuma_megumi@example.com
高橋 夏希	takahashi_natsuki@example.com
中川 満	nakagawa_mitsuru@example.com
田上 ジローラモ	taue_girolamo@example.com
沖田 祐一	okita_yuuichi@example.com
大畑 優一	oohata_yuuichi@example.com
香川 信輔	kagawa_shinsuke@example.com
高尾 めぐみ	takao_megumi@example.com
上条 竜次	kamijou_ryuuji@example.com
平 剛基	taira_yoshiki@example.com
佐々木 博明	sasaki_hiroaki@example.com
三原 綾女	mihara_ayame@example.com
五味 エリカ	gomi_erika@example.com
堀川 一輝	horikawa_kazuki@example.com
米沢 さやか	yonezawa_sayaka@example.com
深田 恭子	fukada_kyouko@example.com
遠藤 奈々	enndou_nana@example.com
松山 達士	matsuyama_tatsuhito@example.com
乾 祐基	inui_yuuki@example.com
水谷 礼子	mizutani_reiko@example.com
馬場 真吾	baba_shingo@example.com
亀山 勝久	kameyama_katsuhisa@example.com
岡野 大	okano_masaru@example.com
妻夫木 倫子	tsumabuki_noriko@example.com
石原 はじめ	ishihara_hajime@example.com
児島 花	kojima_hana@example.com
板倉 ちえみ	itakura_chiemi@example.com
吉田 大五郎	yoshida_daigorou@example.com
寺脇 あおい	terawaki_aoi@example.com
橋本 法子	hashimoto_noriko@example.com
滝川 未華子	takigawa_mikako@example.com
美木 広之	miki_hiroyuki@example.com
大山 大五郎	ooyama_daigorou@example.com
有田 たかお	arita_takao@example.com
大林 真帆	oobayashi_maho@example.com
栗山 美佳	kuriyama_mika@example.com
成田 真奈美	narita_manami@example.com
曽我 真一	soga_shinichi@example.com
岡部 夏希	okabe_natsuki@example.com
北沢 沙知絵	kitazawa_sachie@example.com
宮内 たかお	miyauchi_takao@example.com
鳥居 研二	torii_kenji@example.com
西原 杏	nishihara_ann@example.com
大城 明宏	ooshiro_akihiro@example.com
板垣 徹	itagaki_tooru@example.com
前島 直人	maejima_naoto@example.com
春日 景子	kasuga_keiko@example.com
大内 恵梨香	oouchi_erika@example.com
杉村 碧海	sugimura_ouga@example.com
小菅 祐基	kosuge_yuuki@example.com
藤村 一徳	fujimura_ittoku@example.com
清水 小雁	shimizu_kogan@example.com
石丸 あさみ	ishimaru_asami@example.com
池谷 賢二	iketani_kenji@example.com
神木 千佳子	kamiki_chikako@example.com
阿部 まさし	abe_masashi@example.com
長崎 豊	nagasaki_yutaka@example.com
戸塚 未華子	toduka_mikako@example.com
西井 一代	nishii_kazuyo@example.com
仲村 雅彦	nakamura_masahiko@example.com
岩村 しぼり	iwamura_shibori@example.com
吉原 光良	yoshiwara_teruyoshi@example.com
野崎 人志	nozaki_hitoshi@example.com
目黒 なつみ	meguro_natsumi@example.com
亀井 那奈	kamei_nana@example.com
坂本 まさし	sakamoto_masashi@example.com
諏訪 法嗣	suwa_houshi@example.com
岩沢 光洋	iwasawa_mitsuhiro@example.com
細川 優	hosokawa_yuu1@example.com
広田 明慶	hirota_akiyoshi@example.com
藤山 早織	fujiyama_saori@example.com
小野 幸子	ono_sachiko@example.com
稲田 洋介	inada_yousuke@example.com
新谷 恵麻	araya_ema@example.com
日高 晋也	hidaka_shinya@example.com
須藤 恭子	sudou_kyouko@example.com
横尾 樹里	yokoo_juri@example.com
鹿賀 昴	kaga_subaru@example.com
平井 まみ	hirai_mami@example.com
小関 礼子	kozeki_reiko@example.com
福本 亮	fukumoto_ryou@example.com
高岡 朝陽	takaoka_asahi@example.com
古山 幸子	furuyama_sachiko@example.com
中谷 隆	nakatani_takashi@example.com
井川 悟志	igawa_satoshi@example.com
氏家 はるみ	ujiie_harumi@example.com
梅沢 ジローラモ	umezawa_girolamo@example.com
瀬川 砂羽	segawa_sawa@example.com
野上 ノブヒコ	nogami_nobuhiko@example.com
岡本 ひろ子	okamoto_hiroko@example.com
白川 さやか	shirakawa_sayaka@example.com
遠藤 あさみ	enndou_asami@example.com
三沢 俊二	misawa_shunji@example.com
望月 完爾	mochiduki_kanji@example.com
唐沢 芳正	karasawa_yoshimasa@example.com
吉野 友香	yoshino_tomoka@example.com
中谷 恵梨香	nakatani_erika1@example.com
中園 優	nakazono_yuu@example.com
野島 ヒカル	nojima_hikaru@example.com
桜田 幸平	sakurada_kouhei@example.com
福井 亮	fukui_ryou@example.com
神山 莉央	kamiyama_rio@example.com
土屋 孝太郎	tsuchiya_koutarou@example.com
小原 慶太	ohara_keita@example.com
小玉 礼子	kodama_reiko@example.com
浜 瞬	hama_shun@example.com
小林 瞳	kobayashi_hitomi@example.com
影山 光良	kageyama_teruyoshi@example.com
百瀬 勇	momose_yuu@example.com
小日向 広司	kohinata_kouji@example.com
植木 秀隆	ueki_hidetaka@example.com
石橋 ヒカル	ishibashi_hikaru@example.com
矢島 淳	yajima_atsushi@example.com
遠藤 恵望子	enndou_emiko@example.com
小高 樹里	kodaka_juri@example.com
玉木 ひろ子	tamaki_hiroko@example.com
緒形 あき	ogata_aki@example.com
小川 兼	ogawa_ken@example.com
河野 さとみ	kouno_satomi@example.com
牧 奈々	maki_nana@example.com
阿井 美佳	ai_mika@example.com
高倉 未來	takakura_mirai@example.com
西尾 淳	nishio_atsushi@example.com
永瀬 ひとみ	nagase_hitomi@example.com
萩原 良介	hagiwara_ryousuke@example.com
皆川 広之	minakawa_hiroyuki@example.com
桜井 めぐみ	sakurai_megumi@example.com
佐川 美希	sagawa_miki@example.com
庄司 雅功	shouji_masatoshi@example.com
成田 米蔵	narita_yonezou@example.com
会田 ひとみ	aida_hitomi@example.com
徳田 ケンイチ	tokuta_kenichi@example.com
柴山 鉄洋	shibayama_tetsuhiro@example.com
北村 美希	kitamura_miki@example.com
五大 誠治	godai_seiji@example.com
村上 真奈美	murakami_manami@example.com
井田 そら	ida_sora@example.com
坂本 基祐	sakamoto_kisuke@example.com
星野 優	hoshino_yuu@example.com
海野 一代	umino_kazuyo@example.com
坂野 美幸	itano_miyuki@example.com
今井 フミヤ	imai_fumiya@example.com
寺田 結子	terada_yuuko@example.com
湊 杏	minato_ann@example.com
深沢 勝久	fukazawa_katsuhisa@example.com
原口 勇	haraguchi_yuu@example.com
池上 薫	ikegami_kaoru@example.com
中野 聡	nakano_satoshi@example.com
黒岩 フミヤ	kuroiwa_fumiya@example.com
徳重 明日	tokushige_meibi@example.com
鹿手袋 そら	shikatebukuro_sora@example.com
小久保 遥	kokubo_haruka@example.com
米谷 誠治	yoneya_seiji@example.com
今井 孝太郎	imai_koutarou@example.com
柴崎 竜也	shibazaki_tatsuya@example.com
児玉 さやか	kodama_sayaka@example.com
熊谷 たかお	kumagaya_takao@example.com
井上 那奈	inoue_nana@example.com
北山 慢太郎	kitayama_mantarou@example.com
成海 美里	narumi_miri@example.com
笹原 みあ	sasahara_mia@example.com
岩淵 由美子	iwabuchi_yumiko@example.com
大和 明宏	yamato_akihiro@example.com
三好 光博	miyoshi_mitsuhiro@example.com
哀川 七世	aikawa_nanase@example.com
栗原 秀隆	kurihara_hidetaka@example.com
古山 精児	furuyama_seiji@example.com
岸部 未華子	kishibe_mikako@example.com
岸田 春樹	kishida_haruki@example.com
高原 徹	takahara_tohru@example.com
池田 花	ikeda_hana@example.com
井川 俊二	igawa_shunji@example.com
伊丹 麗奈	itami_rena@example.com
川畑 涼子	kawahata_ryouko@example.com
江崎 誠一	ezaki_seiichi@example.com
佐々木 優	sasaki_yuu@example.com
松沢 竜也	matsuzawa_tatsuya@example.com
黒木 雅彦	kuroki_masahiko@example.com
徳田 勤	tokuta_tsutomu@example.com
森脇 窈	moriwaki_you@example.com
河原 恭子	kawahara_kyouko@example.com
寺島 六郎	terajima_rokurou@example.com
高畑 公顕	takahata_kimiaki@example.com
合田 慢太郎	aida_mantarou@example.com
坂元 一恵	sakamoto_kadue@example.com
奥村 由宇	okumura_yuu@example.com
小池 恵子	koike_keiko@example.com
小椋 雅彦	ogura_masahiko@example.com
戸塚 浩太郎	toduka_koutarou@example.com
宮野 勇介	miyano_yuusuke@example.com
小原 七世	ohara_nanase@example.com
藤田 誠一	fujita_seiichi@example.com
堀内 未華子	horiuchi_mikako@example.com
寺島 一	terajima_hajime@example.com
岡本 ケンイチ	okamoto_kenichi@example.com
柳 みき	yanagi_miki@example.com
篠山 マサカズ	shinoyama_masakazu@example.com
山上 麻由子	yamagami_mayuko@example.com
中谷 あい	nakatani_ai@example.com
生田 菜摘	namata_natsumi@example.com
丹野 信吾	tannno_shingo@example.com
伊集院 みゆき	ijuuin_miyuki@example.com
樋口 小雁	higuchi_kogan@example.com
浦野 誠一	urano_seiichi@example.com
山田 えみ	yamada_emi@example.com
大沢 育子	oosawa_ikuko@example.com
石本 景子	ishimoto_keiko@example.com
小原 れいな	ohara_reina@example.com
大谷 勤	ootani_tsutomu@example.com
堀越 美帆	horikoshi_miho@example.com
米沢 恵子	yonezawa_keiko@example.com
三宅 聖陽	miyake_masaaki@example.com
宮地 えみ	miyaji_emi@example.com
河合 裕次郎	kawai_yuujirou@example.com
鬼頭 大五郎	kitou_daigorou@example.com
柳家 輝信	yanagiya_akinobu@example.com
田辺 千佳子	tanabe_chikako@example.com
川原 兼	kawahara_ken@example.com
筧 三省	kakei_sansei@example.com
角 あい	sumi_ai@example.com
小椋 由樹	ogura_yuki@example.com
橋爪 美里	hashidume_miri@example.com
赤羽 基祐	akabane_kisuke@example.com
藤 さとみ	fuji_satomi@example.com
伊藤 涼子	itou_ryouko@example.com
宮迫 大	miyasako_masaru@example.com
富岡 一代	tomioka_kazuyo@example.com
浅田 晋也	asada_shinya@example.com
今田 涼	imada_ryou@example.com
神野 育子	kamino_ikuko@example.com
中川 憲一	nakagawa_kenichi@example.com
小松 まひる	komatsu_mahiru@example.com
樋口 雄太	higuchi_yuuta@example.com
木村 寛	kimura_hiroshi@example.com
城咲 慢太郎	shirosaki_mantarou@example.com
植村 れいな	uemura_reina@example.com
小平 美帆	kohira_miho@example.com
市川 雅彦	ichikawa_masahiko@example.com
山川 礼子	yamakawa_reiko@example.com
小出 華子	koide_hanako@example.com
大川 はるか	ookawa_haruka@example.com
細川 悟志	hosokawa_satoshi@example.com
田辺 彩	tanabe_aya@example.com
中山 ちえみ	nakayama_chiemi@example.com
寺田 博之	terada_hiroyuki@example.com
沢 なぎさ	sawa_nagisa@example.com
本橋 はるか	motohashi_haruka@example.com
有村 ひろ子	arimura_hiroko@example.com
山内 竜也	yamanouchi_tatsuya@example.com
山田 さとみ	yamada_satomi@example.com
織田 真一	oda_shinichi@example.com
平賀 聖陽	hiraga_masaaki@example.com
栗山 幸子	kuriyama_sachiko@example.com
堤 長利	tsutsumi_nagatoshi@example.com
及川 華子	oikawa_hanako@example.com
板橋 昴	itabashi_subaru@example.com
哀川 妃里	aikawa_yuri@example.com
古賀 美月	koga_miduki@example.com
長崎 博之	nagasaki_hiroyuki@example.com
岩間 美帆	iwama_miho@example.com
紺野 愛子	konno_aiko@example.com
高島 恵美	takashima_megumi@example.com
佐川 圭	sagawa_kei@example.com
片桐 明	katagiri_akira@example.com
田畑 直人	tabata_naoto@example.com
三宅 惇	miyake_atsushi@example.com
筧 理紗	kakei_risa@example.com
高田 憲一	takada_kenichi@example.com
高原 瞬	takahara_shun@example.com
大島 有起哉	ooshima_yukiya@example.com
倉持 有起哉	kuramochi_yukiya@example.com
岩田 丈史	iwata_takeshi@example.com
小池 りえ	koike_rie@example.com
鹿手袋 真吾	shikatebukuro_shingo@example.com
坂下 宏	sakashita_hiroshi@example.com
植田 大樹	ueta_hiroki@example.com
近藤 文世	kondou_fumiyo@example.com
成瀬 ひろみ	naruse_hiromi@example.com
勝地 哲平	katsudi_teppei@example.com
二宮 まさみ	ninomiya_masami@example.com
鶴岡 有起哉	tsuruoka_yukiya@example.com
藤本 愛菜	fujimoto_aina@example.com
立石 里穂	tachiishi_riho@example.com
恩田 輝信	onnda_akinobu@example.com
織田 正義	oda_masayoshi@example.com
宮川 たまき	miyakawa_tamaki@example.com
大河内 祐一	ookouchi_yuuichi@example.com
横田 明宏	yokota_akihiro@example.com
赤羽 景子	akabane_keiko@example.com
臼井 麻由子	usui_mayuko@example.com
小林 サダヲ	kobayashi_sadawo@example.com
入江 美帆	irie_miho@example.com
藤川 一樹	fujikawa_kazuki@example.com
前田 杏	maeda_ann@example.com
小田 勇介	oda_yuusuke@example.com
水野 恵梨香	mizuno_erika@example.com
根本 哲平	nemoto_teppei@example.com
深沢 宏行	fukazawa_hiroyuki@example.com
大城 米蔵	ooshiro_yonezou@example.com
岡山 未華子	okayama_mikako@example.com
磯野 莉緒	isono_rio@example.com
藤木 徹	fujiki_tohru@example.com
石井 薫	ishii_kaoru@example.com
佐久間 ジローラモ	sakuma_girolamo@example.com
新谷 くるみ	araya_kurumi@example.com
西本 涼子	nishimoto_ryouko@example.com
大橋 真一	oohashi_shinichi@example.com
岸 ひとり	kishi_hitori1@example.com
岩城 勇	iwaki_yuu@example.com
今井 和之	imai_kazuyuki@example.com
小山 美帆	oyama_miho@example.com
平 洋介	taira_yousuke@example.com
五十嵐 華子	igarashi_hanako@example.com
小川 了	ogawa_ryou@example.com
山上 新太	yamagami_arata@example.com
岩佐 勤	iwasa_tsutomu@example.com
中川 栄一	nakagawa_eiichi@example.com
下田 理紗	shimoda_risa@example.com
野島 聡	nojima_satoshi@example.com
藤山 明宏	fujiyama_akihiro@example.com
赤木 そら	akagi_sora@example.com
亀山 満	kameyama_mitsuru@example.com
小市 隼士	koichi_shunji@example.com
今野 愛子	imano_aiko@example.com
柴咲 菜摘	shibasaki_natsumi@example.com
安部 優	abe_yuu@example.com
佐々木 雄太	sasaki_yuuta@example.com
吉川 隼士	yoshikawa_shunji@example.com
市川 千佳子	ichikawa_chikako@example.com
田淵 文世	tabuchi_fumiyo@example.com
片岡 良介	kataoka_ryousuke@example.com
浜田 光	hamada_hikaru@example.com
影山 玲那	kageyama_rena@example.com
奥野 由宇	okuno_yuu@example.com
金田 遥	kaneda_haruka@example.com
花田 明	hanada_akira@example.com
金沢 光良	kanezawa_teruyoshi@example.com
藤崎 哲平	fujisaki_teppei@example.com
相原 豊	aihara_yutaka1@example.com
川瀬 遥	kawase_haruka@example.com
大森 信輔	oomori_shinsuke@example.com
松山 洋介	matsuyama_yousuke@example.com
酒井 由宇	sakai_yuu@example.com
三島 麗奈	mishima_rena@example.com
山瀬 雅彦	yamase_masahiko@example.com
北 理紗	kita_risa@example.com
横川 努	yokokawa_tsutomu@example.com
高谷 恵梨香	takaya_erika@example.com
須賀 瞬	suga_shun@example.com
朝倉 さとみ	asakura_satomi@example.com
河内 美里	kawauchi_miri@example.com
瀬川 まみ	segawa_mami@example.com
森口 真帆	moriguchi_maho@example.com
田代 美佐子	tashiro_misako@example.com
大槻 陽介	ootsuki_yousuke@example.com
渡辺 郁恵	watanabe_ikue@example.com
橘 憲史	tachibana_norihito@example.com
笹原 知世	sasahara_chise@example.com
森島 美佐子	morishima_misako@example.com
板垣 まなみ	itagaki_manami@example.com
石野 貴美子	ishino_kimiko@example.com
吉川 知世	kikkawa_chise@example.com
中原 景子	nakahara_keiko@example.com
平松 美里	hiramatsu_miri@example.com
高柳 ケンイチ	takayanagi_kenichi@example.com
土谷 美月	tsuchiya_miduki@example.com
松岡 淳子	matsuoka_atsuko@example.com
富田 光	tomita_hikaru@example.com
池畑 明	ikehata_akira@example.com
塩見 花	shiomi_hana@example.com
小寺 綾女	kodera_ayame@example.com
池谷 コウ	iketani_kou@example.com
佐野 路子	sano_michiko@example.com
吉田 淳子	yoshida_atsuko@example.com
細井 了	hosoi_ryou@example.com
平野 一代	hirano_kazuyo@example.com
篠原 洋	shinohara_you@example.com
金児 惇	kaneko_atsushi@example.com
有馬 美幸	arima_miyuki@example.com
金森 信吾	kanamori_shingo@example.com
川合 良介	kawai_ryousuke@example.com
沢田 明	sawada_akira@example.com
竹原 きみまろ	takehara_kimimaro@example.com
関 ひろみ	seki_hiromi@example.com
熊井 敏和	kumai_toshikazu@example.com
西井 彩	nishii_aya@example.com
伴 礼子	ban_reiko@example.com
赤松 徹	akamatsu_tooru@example.com
岩本 茜	iwamoto_akane@example.com
小松 博之	komatsu_hiroyuki@example.com
葛西 恵子	kasai_keiko@example.com
久保田 恵望子	kubota_emiko@example.com
増井 京子	masui_kyouko@example.com
小畑 由樹	obata_yuki@example.com
田畑 結衣	tabata_yui@example.com
藤澤 憲史	fujisawa_norihito@example.com
榊原 信輔	sakakibara_shinsuke@example.com
矢島 慢太郎	yajima_mantarou@example.com
小沼 六郎	konuma_rokurou@example.com
大場 きみまろ	ooba_kimimaro@example.com
三枝 晴臣	sannshi_haruomi@example.com
吉原 小雁	yoshiwara_kogan@example.com
水野 めぐみ	mizuno_megumi@example.com
坂田 花	sakata_hana@example.com
藤田 博之	fujita_hiroyuki@example.com
植村 瑠璃亜	uemura_ruria@example.com
浅田 ひろみ	asada_hiromi@example.com
早美 公顕	hayami_kimiaki@example.com
岡崎 礼子	okazaki_reiko@example.com
富樫 恭子	togashi_kyouko@example.com
土橋 礼子	tsuchihashi_reiko@example.com
大浦 朝香	ooura_asaka@example.com
土谷 あい	tsuchiya_ai@example.com
西谷 勇	nishiya_yuu@example.com
酒井 翔子	sakai_shouko@example.com
大和田 精児	oowada_seiji@example.com
川原 真帆	kawahara_maho@example.com
古田 功補	furuta_kousuke@example.com
内山 愛子	uchiyama_aiko@example.com
戎 人志	ebisu_hitoshi@example.com
生田 彩華	namata_ayaka@example.com
中西 エリカ	nakanishi_erika@example.com
西村 了	nishimura_ryou@example.com
長岡 しほり	nagaoka_shihori@example.com
馬場 染五郎	baba_somegorou@example.com
南部 はるみ	nannbu_harumi@example.com
寺本 敏和	teramoto_toshikazu@example.com
青野 ジローラモ	aono_girolamo@example.com
那須 りえ	nasu_rie@example.com
依田 紗季	yorita_saki@example.com
安永 知史	yasunaga_tomofumi@example.com
辻本 一代	tsujimoto_kazuyo@example.com
楠 一	kusunoki_hajime@example.com
鈴木 菜摘	suzuki_natsumi@example.com
本多 恵麻	honnda_ema@example.com
大塚 大樹	ootsuka_hiroki@example.com
野村 沙耶	nomura_saya@example.com
高山 晴臣	takayama_haruomi@example.com
滝本 祐一	takimoto_yuuichi@example.com
荻野 涼	ogino_ryou@example.com
菊田 広司	kikuta_kouji@example.com
萩原 なつみ	hagiwara_natsumi@example.com
小木 サダヲ	ogi_sadawo@example.com
溝口 文世	mizoguchi_fumiyo@example.com
清水 竜也	shimizu_tatsuya@example.com
杉田 由美子	sugita_yumiko@example.com
多岐川 ケンイチ	takigawa_kenichi@example.com
岡野 玲那	okano_rena@example.com
長浜 研二	nagahama_kenji@example.com
今 敦	ima_atsushi@example.com
吉沢 華子	yoshizawa_hanako@example.com
森 さやか	mori_sayaka@example.com
安井 幸子	yasui_sachiko@example.com
深谷 扶樹	fukaya_motoki@example.com
坂上 一恵	sakagami_kadue@example.com
勝又 菊生	katsumata_kikuo@example.com
香椎 綾女	kashii_ayame@example.com
山瀬 美幸	yamase_miyuki@example.com
柴崎 なぎさ	shibazaki_nagisa@example.com
目黒 明	meguro_akira@example.com
五十嵐 研二	igarashi_kenji@example.com
瀬戸 憲史	seto_norihito@example.com
戸塚 芳正	toduka_yoshimasa@example.com
伊沢 薫	izawa_kaoru@example.com
保坂 一哉	hosaka_kazuya@example.com
岡本 茜	okamoto_akane@example.com
高畑 ひろ子	takahata_hiroko@example.com
小倉 克実	ogura_katsumi@example.com
柳田 結衣	yanagida_yui@example.com
戸田 光	toda_hikaru@example.com
河合 ケンイチ	kawai_kenichi@example.com
田島 基祐	tajima_kisuke@example.com
加納 小雁	kanou_kogan@example.com
小堀 瞳	kohori_hitomi@example.com
岩永 なつみ	iwanaga_natsumi@example.com
中尾 建	nakao_ken@example.com
黒田 小雁	kurota_kogan@example.com
城戸 淳子	kido_atsuko@example.com
伊東 玲那	itou_rena@example.com
宮本 くるみ	miyamoto_kurumi@example.com
有田 みゆき	arita_miyuki@example.com
土居 彩華	doi_ayaka@example.com
浅川 豊	asakawa_yutaka@example.com
宮脇 恵子	miyawaki_keiko@example.com
有村 敏也	arimura_toshiya@example.com
曽根 あや子	sone_ayako@example.com
荻原 未來	hagiwara_mirai@example.com
野呂 美希	noro_miki@example.com
内海 由樹	uchimi_yuki@example.com
丹野 竜也	tannno_tatsuya@example.com
小泉 ひろみ	koizumi_hiromi@example.com
池畑 綾	ikehata_aya@example.com
若山 勇介	wakayama_yuusuke@example.com
河合 美優	kawai_myuu@example.com
土田 知史	tsuchida_tomofumi@example.com
滝沢 兼	takizawa_ken@example.com
宮沢 璃子	miyazawa_riko@example.com
安達 サンタマリア	adachi_stmaria@example.com
富永 さやか	tominaga_sayaka@example.com
梅本 晋也	umemoto_shinya@example.com
宮迫 綾女	miyasako_ayame@example.com
伊崎 めぐみ	isaki_megumi@example.com
岡村 奈央	okamura_nao@example.com
金田 朝陽	kaneda_asahi@example.com
後藤 大	gotou_masaru@example.com
小高 恵梨香	kodaka_erika@example.com
浅田 だん吉	asada_dankichi@example.com
森永 優	morinaga_yuu@example.com
筧 早織	kakei_saori@example.com
柳川 人志	yanagawa_hitoshi@example.com
喜多 メイサ	kita_meisa@example.com
山中 龍吉	yamanaka_ryuukichi@example.com
紺野 豊	konnno_yutaka@example.com
笠井 みあ	kasai_mia@example.com
五十嵐 ひろ子	igarashi_hiroko@example.com
寺岡 勝久	teraoka_katsuhisa@example.com
生瀬 亜希	namase_aki@example.com
寺岡 さんま	teraoka_sanma@example.com
太田 ケンイチ	oota_kenichi@example.com
阿井 愛	ai_ai@example.com
細井 直人	hosoi_naoto@example.com
芳賀 たまき	haga_tamaki@example.com
吉岡 なぎさ	yoshioka_nagisa@example.com
今西 かおり	imanishi_kaori@example.com
勝田 綾	katsuda_aya@example.com
宇多田 雅之	utada_masayuki@example.com
北条 隆之介	houjou_ryuunosuke@example.com
黒川 徹平	kurokawa_teppei@example.com
金井 憲史	kanai_norihito@example.com
岩佐 博之	iwasa_hiroyuki@example.com
石原 菊生	ishihara_kikuo@example.com
神山 さやか	kamiyama_sayaka@example.com
牧田 健	makita_ken@example.com
菊田 路子	kikuta_michiko@example.com
内海 丈雄	uchimi_takeo@example.com
石原 淳子	ishihara_atsuko@example.com
藤川 みゆき	fujikawa_miyuki@example.com
大久保 米蔵	ookubo_yonezou@example.com
麻生 エリカ	asou_erika@example.com
畑 恵子	hatake_keiko@example.com
三村 麻由子	mimura_mayuko@example.com
谷口 知世	taniguchi_chise@example.com
柏原 翔	kashiwara_shou@example.com
横川 洋介	yokokawa_yousuke@example.com
堀井 弘也	horii_hironari@example.com
佐々木 広司	sasaki_kouji@example.com
市田 菜々美	ichida_nanami@example.com
増田 一徳	masuda_ittoku@example.com
本多 はるみ	honnda_harumi@example.com
五十嵐 光洋	igarashi_mitsuhiro@example.com
若槻 雅彦	wakatsuki_masahiko@example.com
松岡 はるみ	matsuoka_harumi@example.com
川端 翔子	kawabata_shouko@example.com
大石 秀隆	ooishi_hidetaka@example.com
飯田 獅童	iida_shidou@example.com
井手 咲	ide_saki@example.com
平良 徹	hirara_tohru@example.com
深沢 三郎	fukazawa_saburou@example.com
村松 兼	muramatsu_ken@example.com
松本 敏和	matsumoto_toshikazu@example.com
下田 エリカ	shimoda_erika@example.com
玉木 正義	tamaki_masayoshi@example.com
川原 染五郎	kawahara_somegorou@example.com
森下 竜也	morishita_tatsuya@example.com
新谷 和久	araya_kazuhisa@example.com
大平 たかお	oohira_takao@example.com
伊丹 涼	itami_ryou1@example.com
滝本 精児	takimoto_seiji@example.com
余 ヒカル	yo_hikaru@example.com
笹原 崇史	sasahara_takashi@example.com
結城 明	yuuki_akira@example.com
相沢 扶樹	aizawa_motoki@example.com
砂川 詩織	sunakawa_shiori@example.com
柳 恵望子	yanagi_emiko@example.com
小堀 奈月	kohori_natsuki@example.com
土井 豊	doi_yutaka@example.com
宮崎 達士	miyazaki_tatsuhito@example.com
小森 莉央	komori_rio@example.com
都築 育子	tsuduki_ikuko@example.com
藤井 なつみ	fujii_natsumi@example.com
小山 美佐子	oyama_misako@example.com
中園 進	nakazono_susumu@example.com
佐藤 ケンイチ	satou_kenichi@example.com
坂口 竜也	sakaguchi_tatsuya@example.com
関根 寿明	sekine_toshiaki@example.com
浅利 晋也	asari_shinya@example.com
田上 恵麻	taue_ema@example.com
ほしの 莉央	hoshino_rio@example.com
金井 新太	kanai_arata@example.com
桜井 直人	sakurai_naoto@example.com
花岡 陽介	hanaoka_yousuke@example.com
浜田 太朗	hamada_tarou@example.com
大路 三省	ooji_sansei@example.com
高橋 優	takahashi_yuu@example.com
芹沢 充則	serizawa_mitsunori@example.com
綾瀬 早織	ayase_saori@example.com
高山 良介	takayama_ryousuke@example.com
中岡 美里	nakaoka_miri@example.com
菅谷 弘也	sugaya_hironari@example.com
大坪 美和子	ootsubo_miwako@example.com
久米 憲一	kume_kenichi@example.com
有馬 照生	arima_teruo@example.com
乾 栄一	inui_eiichi@example.com
野沢 徹	nozawa_tooru@example.com
山田 蒼甫	yamada_sousuke@example.com
水上 美紀	mizukami_miki@example.com
岡部 雅彦	okabe_masahiko@example.com
滝田 遥	takita_haruka@example.com
深井 有海	fukai_ami@example.com
本間 未華子	honma_mikako@example.com
坂本 一恵	sakamoto_kadue1@example.com
大和 慶太	yamato_keita@example.com
石原 沙耶	ishihara_saya@example.com
村松 太朗	muramatsu_tarou@example.com
和泉 真奈美	waizumi_manami@example.com
河本 茜	koumoto_akane@example.com
三船 美帆	mifune_miho@example.com
照井 菊生	terui_kikuo@example.com
平塚 美幸	hiratsuka_miyuki@example.com
平 有海	taira_ami@example.com
村井 茂樹	murai_shigeki@example.com
永田 恵望子	nagata_emiko@example.com
有田 美智子	arita_michiko@example.com
小野 碧海	ono_ouga@example.com
真鍋 貴美子	manabe_kimiko@example.com
泉 なぎさ	izumi_nagisa@example.com
武藤 だん吉	mutou_dankichi@example.com
門田 砂羽	kadota_sawa@example.com
坂東 翔子	banntou_shouko@example.com
木戸 莉沙	kido_risa@example.com
明石 さゆり	akashi_sayuri@example.com
松野 京子	matsuno_kyouko@example.com
谷川 幸子	tanikawa_sachiko@example.com
滝口 めぐみ	takiguchi_megumi@example.com
飯野 なつみ	iino_natsumi@example.com
長谷川 一輝	hasegawa_kazuki@example.com
長井 コウ	nagai_kou@example.com
森下 ノブヒコ	morishita_nobuhiko@example.com
石原 朝香	ishihara_asaka@example.com
泉 優一	izumi_yuuichi@example.com
綾瀬 杏	ayase_ann@example.com
美木 雅彦	miki_masahiko@example.com
七瀬 美佳	nanase_mika@example.com
仲村 育子	nakamura_ikuko@example.com
森川 和久	morikawa_kazuhisa@example.com
柳田 さゆり	yanagida_sayuri@example.com
小泉 恭子	koizumi_kyouko@example.com
成海 砂羽	narumi_sawa@example.com
高樹 精児	takagi_seiji@example.com
梅原 光	umehara_hikaru@example.com
中林 ひろ子	nakabayashi_hiroko@example.com
深沢 光良	fukazawa_teruyoshi@example.com
六角 結子	rokkaku_yuuko@example.com
浜田 綾	hamada_aya@example.com
宮本 里穂	miyamoto_riho@example.com
安達 敦	adachi_atsushi@example.com
ト字 竜也	toji_tatsuya@example.com
毛利 芳正	mouri_yoshimasa@example.com
坂口 剛基	sakaguchi_yoshiki@example.com
小沢 直人	ozawa_naoto@example.com
平沢 仁	hirasawa_jin@example.com
松岡 亮	matsuoka_ryou@example.com
小泉 里奈	koizumi_rina@example.com
首藤 倫子	sudou_noriko@example.com
吉野 研二	yoshino_kenji@example.com
渋谷 まさし	shibuya_masashi@example.com
島津 和久	shimadu_kazuhisa@example.com
乾 涼	inui_ryou@example.com
塚本 達士	tsukamoto_tatsuhito@example.com
沖 圭	oki_kei@example.com
神原 真希	kannbara_maki@example.com
奥 奈々	oku_nana@example.com
藤原 竜也	fujiwara_tatsuya@example.com
北原 美咲	kitahara_misaki@example.com
土橋 基祐	tsuchihashi_kisuke@example.com
金子 草太	kaneko_souta@example.com
上野 愛梨	ueno_airi@example.com
浜崎 沙知絵	hamasaki_sachie@example.com
堀口 博明	horiguchi_hiroaki@example.com
大野 憲一	oono_kenichi@example.com
前田 コウ	maeda_kou@example.com
加納 かおり	kanou_kaori@example.com
川野 涼子	kawano_ryouko@example.com
大内 将也	oouchi_masaya@example.com
栗山 丈史	kuriyama_takeshi@example.com
上野 さとみ	ueno_satomi@example.com
生田 栄一	namata_eiichi@example.com
植木 美幸	ueki_miyuki@example.com
志水 ひかり	shimizu_hikari@example.com
坂元 明	sakamoto_akira@example.com
岩下 陽子	iwashita_youko@example.com
浅見 慶太	asami_keita@example.com
神木 美月	kamiki_miduki@example.com
菅井 愛菜	sugai_aina@example.com
西村 ノブヒコ	nishimura_nobuhiko@example.com
大川 恵子	ookawa_keiko@example.com
瀬戸 妃里	seto_yuri@example.com
松島 研二	matsushima_kenji@example.com
妻夫木 功補	tsumabuki_kousuke@example.com
葛山 桃子	katsurayama_momoko@example.com
田尻 努	tajiri_tsutomu@example.com
米山 美紀	yoneyama_miki@example.com
井川 仁晶	igawa_hiroaki@example.com
目黒 克実	meguro_katsumi@example.com
中原 徹	nakahara_tohru@example.com
角谷 ひかり	kadotani_hikari@example.com
小堀 ヒカル	kohori_hikaru@example.com
桜田 達士	sakurada_tatsuhito@example.com
三井 礼子	mitsui_reiko@example.com
藤田 詩織	fujita_shiori@example.com
中里 さやか	nakazato_sayaka1@example.com
岡 ケンイチ	oka_kenichi@example.com
近藤 恵麻	konndou_ema@example.com
秋山 直人	akiyama_naoto@example.com
馬場 薫	baba_kaoru@example.com
安倍 悟志	abe_satoshi@example.com
落合 ヒロ	ochiai_hiro@example.com
北原 広之	kitahara_hiroyuki@example.com
三枝 知史	sannshi_tomofumi@example.com
小野田 一代	onoda_kazuyo@example.com
小川 早紀	ogawa_saki@example.com
根本 光	nemoto_hikaru@example.com
奥貫 ヒロ	okunuki_hiro1@example.com
西谷 直人	nishiya_naoto@example.com
田口 由樹	taguchi_yuki@example.com
辻 あおい	tsuji_aoi@example.com
白川 豊	shirakawa_yutaka@example.com
古賀 豊	koga_yutaka@example.com
奥貫 克実	okunuki_katsumi@example.com
谷村 徹	tanimura_tohru@example.com
小関 あや子	kozeki_ayako@example.com
相田 勇	aida_yuu@example.com
松岡 杏	matsuoka_ann@example.com
鎌田 光	kamata_hikaru@example.com
森 メイサ	mori_meisa@example.com
三枝 ヒカル	sannshi_hikaru@example.com
山村 くるみ	yamamura_kurumi@example.com
小野 満	ono_mitsuru@example.com
甲斐 俊二	kai_shunji@example.com
小谷 美優	kotani_myuu@example.com
塚原 彩	tsukahara_aya@example.com
上杉 美嘉	uesugi_mika@example.com
福士 夏空	fukushi_sora@example.com
谷 大	tani_masaru@example.com
黒川 洋介	kurokawa_yousuke@example.com
根岸 博之	negishi_hiroyuki@example.com
深沢 育子	fukazawa_ikuko@example.com
三木 芽以	miki_mei@example.com
鹿島 マサカズ	kashima_masakazu@example.com
田畑 未來	tabata_mirai@example.com
斎藤 真一	saitou_shinichi@example.com
杉山 由美子	sugiyama_yumiko@example.com
浅見 奈々	asami_nana@example.com
山田 優	yamada_yuu@example.com
大和田 莉緒	oowada_rio@example.com
栗林 友香	kuribayashi_tomoka@example.com
宮野 小雁	miyano_kogan@example.com
長澤 草太	nagasawa_souta@example.com
北川 美幸	kitagawa_miyuki@example.com
岩城 三郎	iwaki_saburou@example.com
小堀 法嗣	kohori_houshi@example.com
鹿手袋 勇	shikatebukuro_yuu@example.com
岩井 美里	iwai_miri@example.com
山中 愛	yamanaka_ai@example.com
三村 昴	mimura_subaru@example.com
坂東 恵子	banntou_keiko@example.com
小野 美幸	ono_miyuki@example.com
大矢 倫子	ooya_noriko@example.com
杉山 友香	sugiyama_tomoka@example.com
丸山 精児	maruyama_seiji@example.com
川村 慢太郎	kawamura_mantarou@example.com
深沢 正敏	fukazawa_masatoshi@example.com
稲葉 龍吉	inaba_ryuukichi@example.com
岩佐 徹	iwasa_tooru@example.com
川端 ヒカル	kawabata_hikaru@example.com
阪本 薫	sakamoto_kaoru@example.com
下村 小百合	shimomura_sayuri@example.com
荒川 浩太郎	arakawa_koutarou@example.com
津田 育二	tsuda_ikuji@example.com
小市 長利	koichi_nagatoshi@example.com
百瀬 恵梨香	momose_erika@example.com
熊倉 豊	kumakura_yutaka@example.com
大平 ノブヒコ	oohira_nobuhiko@example.com
中原 美紀	nakahara_miki@example.com
北 莉沙	kita_risa1@example.com
中本 紗季	nakamoto_saki@example.com
牧瀬 知史	makise_tomofumi@example.com
畑 陽子	hatake_youko@example.com
芹沢 憲史	serizawa_norihito@example.com
北川 鉄二	kitakawa_tetsuji@example.com
奈良 樹里	nara_juri@example.com
大木 聡	ooki_satoshi@example.com
三沢 広之	misawa_hiroyuki@example.com
日比野 莉緒	hibino_rio@example.com
井沢 昴	izawa_subaru@example.com
大原 知史	oohara_tomofumi@example.com
大畑 昴	oohata_subaru@example.com
徳田 芳正	tokuta_yoshimasa@example.com
梅沢 雅功	umezawa_masatoshi@example.com
坂本 薫	sakamoto_kaoru1@example.com
新田 建	arata_ken@example.com
藤澤 寿明	fujisawa_toshiaki@example.com
唐沢 美希	karasawa_miki@example.com
亀田 小百合	kameda_sayuri@example.com
松村 朝陽	matsumura_asahi@example.com
熊田 まひる	kumada_mahiru@example.com
三宅 美佐子	miyake_misako@example.com
影山 景子	kageyama_keiko@example.com
竹本 進	takemoto_susumu@example.com
北 英嗣	kita_hidetsugu@example.com
那須 莉沙	nasu_risa@example.com
森 美幸	mori_miyuki@example.com
中原 詩織	nakahara_shiori@example.com
福井 雅彦	fukui_masahiko@example.com
真鍋 寿々花	manabe_suzuka@example.com
橋口 恵梨香	hashiguchi_erika@example.com
橋本 優	hashimoto_yuu@example.com
横川 南朋	yokokawa_nao@example.com
亀田 隼士	kameda_shunji@example.com
市原 景子	ichihara_keiko@example.com
福本 美佳	fukumoto_mika@example.com
内村 明日	uchimura_meibi@example.com
岡崎 たかお	okazaki_takao@example.com
加藤 高史	katou_takashi@example.com
森下 拓郎	morishita_takurou@example.com
仲村 愛梨	nakamura_airi@example.com
大木 敏和	ooki_toshikazu@example.com
宇田川 奈月	udagawa_natsuki@example.com
広田 小百合	hirota_sayuri@example.com
水崎 光良	misaki_teruyoshi@example.com
瀬戸 彩華	seto_ayaka@example.com
末永 勇一	suenaga_yuuichi@example.com
小松 真奈美	komatsu_manami@example.com
門脇 研二	kadowaki_kenji@example.com
星 俊介	hoshi_shunsuke@example.com
前野 美里	maeno_miri@example.com
寺田 徹平	terada_teppei@example.com
山崎 俊二	yamazaki_shunji@example.com
三谷 千佳子	mitani_chikako@example.com
荻野 景子	ogino_keiko@example.com
下田 なぎさ	shimoda_nagisa@example.com
柳田 淳	yanagida_atsushi@example.com
田中 正敏	tanaka_masatoshi@example.com
金沢 真吾	kanezawa_shingo@example.com
石本 郁恵	ishimoto_ikue@example.com
高梨 広司	takanashi_kouji@example.com
小笠原 さやか	ogasawara_sayaka@example.com
米山 寿明	yoneyama_toshiaki@example.com
川端 しほり	kawabata_shihori@example.com
小幡 由樹	obata_yuki1@example.com
堀越 裕司	horikoshi_yuuji@example.com
大高 明	oodaka_akira@example.com
柴崎 菊生	shibazaki_kikuo@example.com
中島 裕司	nakashima_yuuji@example.com
竹中 薫	takenaka_kaoru@example.com
菅 祐一	suga_yuuichi@example.com
大内 豊	oouchi_yutaka@example.com
野原 美菜	nohara_mina@example.com
柴咲 はるか	shibasaki_haruka@example.com
伊崎 貴美子	isaki_kimiko@example.com
石沢 光	ishizawa_hikaru@example.com
南 由樹	minami_yuki@example.com
熊田 了	kumada_ryou@example.com
八木 扶樹	yagi_motoki@example.com
長谷川 ヒカル	hasegawa_hikaru1@example.com
氏家 竜也	ujiie_tatsuya@example.com
小野寺 祐基	onodera_yuuki@example.com
有村 右京	arimura_ukyou@example.com
小菅 浩介	kosuge_kousuke@example.com
藤原 妃里	fujiwara_yuri@example.com
細井 愛梨	hosoi_airi@example.com
西本 育子	nishimoto_ikuko@example.com
本山 芳正	honnyama_yoshimasa@example.com
阪本 一徳	sakamoto_ittoku@example.com
野本 慎之介	nomoto_shinnosuke@example.com
池畑 勇介	ikehata_yuusuke@example.com
宇多田 幸子	utada_sachiko@example.com
宮本 沙知絵	miyamoto_sachie@example.com
横田 優	yokota_yuu@example.com
寺井 健	terai_ken@example.com
麻生 悟志	asou_satoshi@example.com
寺尾 丈雄	terao_takeo@example.com
渡辺 真悠子	watanabe_mayuko@example.com
長野 慢太郎	nagano_mantarou@example.com
長谷川 夏希	hasegawa_natsuki@example.com
千田 あき	sennda_aki@example.com
宇都宮 ひかり	utsunomiya_hikari@example.com
角田 莉央	kadota_rio@example.com
内海 幸平	uchimi_kouhei@example.com
小宮 俊介	komiya_shunsuke@example.com
本山 明慶	honnyama_akiyoshi@example.com
坂下 かおり	sakashita_kaori@example.com
中野 一樹	nakano_kazuki@example.com
城戸 あおい	kido_aoi@example.com
柳田 麻由子	yanagida_mayuko@example.com
鶴田 ケンイチ	tsuruta_kenichi@example.com
永田 美希	nagata_miki@example.com
大高 太朗	oodaka_tarou@example.com
水口 惇	mizuguchi_atsushi@example.com
一青 だん吉	hitoto_dankichi@example.com
松谷 薫	matsutani_kaoru@example.com
松谷 郁恵	matsutani_ikue@example.com
田尻 なつみ	tajiri_natsumi@example.com
沢 さやか	sawa_sayaka@example.com
三浦 隆太	miura_ryuuta@example.com
林 輝信	hayashi_akinobu@example.com
一青 寿明	hitoto_toshiaki@example.com
水谷 くるみ	mizutani_kurumi@example.com
白鳥 優一	shiratori_yuuichi@example.com
小室 長利	komuro_nagatoshi@example.com
水島 聖陽	mizushima_masaaki@example.com
長澤 和之	nagasawa_kazuyuki@example.com
日下部 芳正	kusakabe_yoshimasa@example.com
赤松 一徳	akamatsu_ittoku@example.com
飯野 恵梨香	iino_erika@example.com
野島 えみ	nojima_emi@example.com
川田 優	kawata_yuu@example.com
伊崎 正義	isaki_masayoshi@example.com
森井 窈	morii_you@example.com
宮野 奈央	miyano_nao@example.com
久保田 勇	kubota_yuu@example.com
日下部 雅彦	kusakabe_masahiko@example.com
野沢 麻緒	nozawa_mao@example.com
内田 佳乃	uchida_yoshino@example.com
吉崎 さやか	yoshizaki_sayaka@example.com
岩沢 大五郎	iwasawa_daigorou@example.com
浜崎 真一	hamasaki_shinichi@example.com
宮川 夏希	miyakawa_natsuki@example.com
馬場 瞳	baba_hitomi@example.com
米倉 朝香	yonekura_asaka@example.com
柳川 知世	yanagawa_chise@example.com
井川 早織	igawa_saori@example.com
一木 涼	ichiki_ryou@example.com
小野 俊二	ono_shunji@example.com
細川 那奈	hosokawa_nana@example.com
阪口 早織	sakaguchi_saori@example.com
車 夏空	kuruma_sora@example.com
西野 直人	nishino_naoto@example.com
有村 大五郎	arimura_daigorou@example.com
平田 明	hirata_akira@example.com
高島 蒼甫	takashima_sousuke@example.com
中川 育二	nakagawa_ikuji@example.com
勝又 季衣	katsumata_toshie@example.com
西本 将也	nishimoto_masaya@example.com
宮内 メイサ	miyauchi_meisa@example.com
小泉 薫	koizumi_kaoru@example.com
下川 美月	shimokawa_miduki@example.com
小野 啓介	ono_keisuke@example.com
浅野 慶二	asano_keiji@example.com
永井 裕司	nagai_yuuji@example.com
渡部 真一	watabe_shinichi@example.com
結城 瞳	yuuki_hitomi@example.com
中原 綾女	nakahara_ayame@example.com
藤原 千夏	fujiwara_chinatsu@example.com
野村 あさみ	nomura_asami@example.com
矢部 友香	yabe_tomoka@example.com
安永 賢治	yasunaga_kenji@example.com
竹中 寿々花	takenaka_suzuka@example.com
徳重 涼	tokushige_ryou@example.com
平沢 美佐子	hirasawa_misako@example.com
大浦 あき	ooura_aki@example.com
塩見 寿明	shiomi_toshiaki@example.com
佐々木 鉄二	sasaki_tetsuji@example.com
渡辺 亮介	watanabe_ryousuke@example.com
藤岡 克実	fujioka_katsumi@example.com
湯浅 春樹	yuasa_haruki@example.com
仲田 まみ	nakata_mami@example.com
福本 晴臣	fukumoto_haruomi@example.com
大滝 ヒロ	ootaki_hiro@example.com
阿部 勝久	abe_katsuhisa@example.com
平賀 秀隆	hiraga_hidetaka@example.com
堤 くるみ	tsutsumi_kurumi@example.com
高村 利夫	takamura_toshio@example.com
大内 真帆	oouchi_maho@example.com
高井 莉沙	takai_risa@example.com
亀田 獅童	kameda_shidou@example.com
石垣 愛子	ishigaki_aiko@example.com
戸田 恵望子	toda_emiko@example.com
水口 友香	mizuguchi_tomoka@example.com
綾瀬 明宏	ayase_akihiro@example.com
小田 なぎさ	oda_nagisa1@example.com
秋山 妃里	akiyama_yuri@example.com
山中 杏	yamanaka_ann@example.com
石丸 美嘉	ishimaru_mika@example.com
赤木 輝信	akagi_akinobu@example.com
菅澤 美佐	sugasawa_misa@example.com
角谷 照生	kadotani_teruo@example.com
三宅 美幸	miyake_miyuki@example.com
寺井 雄太	terai_yuuta@example.com
塚本 慶二	tsukamoto_keiji@example.com
藤岡 建	fujioka_ken@example.com
西岡 しぼり	nishioka_shibori@example.com
小畑 友香	obata_tomoka@example.com
加瀬 直人	kase_naoto@example.com
萩原 きみまろ	hagiwara_kimimaro@example.com
村上 雅彦	murakami_masahiko@example.com
今井 マサカズ	imai_masakazu@example.com
東 優	higashi_yuu@example.com
亀井 将也	kamei_masaya@example.com
長田 倫子	nagata_noriko@example.com
山野 晃司	yamano_kouji@example.com
玉山 涼子	tamayama_ryouko@example.com
野島 妃里	nojima_yuri@example.com
飯野 亮	iino_ryou@example.com
大木 光良	ooki_teruyoshi@example.com
石山 健	ishiyama_ken@example.com
田川 倫子	tagawa_noriko@example.com
河村 薫	kawamura_kaoru@example.com
原口 悟志	haraguchi_satoshi@example.com
永田 由美子	nagata_yumiko@example.com
桜井 有海	sakurai_ami@example.com
本橋 なつみ	motohashi_natsumi@example.com
井手 鉄二	ide_tetsuji@example.com
西原 薫	nishihara_kaoru@example.com
片桐 美帆	katagiri_miho@example.com
立石 隼士	tachiishi_shunji@example.com
永井 あさみ	nagai_asami@example.com
前野 未華子	maeno_mikako@example.com
花岡 雅彦	hanaoka_masahiko@example.com
滝田 一恵	takita_kadue@example.com
松澤 将也	matsuzawa_masaya@example.com
小田 遥	oda_haruka@example.com
三上 れいな	mikami_reina@example.com
福士 ひとみ	fukushi_hitomi@example.com
寺本 佳乃	teramoto_yoshino@example.com
宮島 知世	miyajima_chise@example.com
竹本 ジローラモ	takemoto_girolamo@example.com
松下 あや子	matsushita_ayako@example.com
高畑 徹	takabata_tooru@example.com
内山 奈月	uchiyama_natsuki@example.com
内山 真吾	uchiyama_shingo@example.com
平 龍吉	taira_ryuukichi@example.com
西野 利夫	nishino_toshio@example.com
福沢 早紀	fukuzawa_saki@example.com
島崎 進	shimazaki_susumu@example.com
小西 真一	konishi_shinichi@example.com
森口 路子	moriguchi_michiko@example.com
岡田 たまき	okada_tamaki@example.com
坂東 賢二	banntou_kenji@example.com
吉井 昌代	yoshii_masayo@example.com
大井 恵子	ooi_keiko@example.com
柳沢 一代	yanagisawa_kazuyo@example.com
豊原 那奈	toyohara_nana@example.com
大林 奈月	oobayashi_natsuki@example.com
角 愛	sumi_ai1@example.com
真鍋 貴美子	manabe_kimiko1@example.com
磯村 勇	isomura_yuu@example.com
池上 裕次郎	ikegami_yuujirou@example.com
岩沢 洋	iwasawa_you@example.com
曽根 貴美子	sone_kimiko@example.com
羽田 聖陽	hata_masaaki@example.com
富永 一輝	tominaga_kazuki@example.com
三輪 杏	miwa_ann@example.com
若松 和久	wakamatsu_kazuhisa@example.com
笠原 礼子	kasahara_reiko@example.com
青柳 人志	aoyagi_hitoshi@example.com
寺田 兼	terada_ken@example.com
坂下 光	sakashita_hikaru@example.com
内村 竜也	uchimura_tatsuya@example.com
若松 あさみ	wakamatsu_asami@example.com
板垣 有起哉	itagaki_yukiya@example.com
堀北 昌代	horikita_masayo@example.com
江口 優	eguchi_yuu@example.com
小室 誠一	komuro_seiichi@example.com
内田 花緑	uchida_karoku@example.com
市村 雅之	ichimura_masayuki@example.com
笠井 啓介	kasai_keisuke@example.com
岩田 奈々	iwata_nana@example.com
佐伯 まさし	saeki_masashi@example.com
岩下 真吾	iwashita_shingo@example.com
三田 早織	mita_saori1@example.com
萩原 めぐみ	hagiwara_megumi@example.com
坪井 恭子	tsuboi_kyouko@example.com
加藤 法子	katou_noriko@example.com
野口 貴嶺	noguchi_takane@example.com
秋田 俊二	akita_shunji@example.com
川畑 涼	kawahata_ryou@example.com
飯田 徹	iida_tooru@example.com
楠 陽子	kusunoki_youko1@example.com
塩田 美佐	shiota_misa@example.com
柴田 なぎさ	shibata_nagisa@example.com
中井 佑	nakai_tasuku@example.com
大津 優	ootsu_yuu@example.com
白鳥 菜摘	shiratori_natsumi@example.com
今井 文世	imai_fumiyo@example.com
余 優	yo_yuu@example.com
滝本 奈々	takimoto_nana@example.com
井手 恵子	ide_keiko@example.com
牧田 洋	makita_you@example.com
滝 秀隆	taki_hidetaka@example.com
遠藤 勇介	enndou_yuusuke@example.com
中山 まみ	nakayama_mami@example.com
妹尾 友以乃	seo_yuino@example.com
古田 明	furuta_akira@example.com
佐久間 はるみ	sakuma_harumi@example.com
草野 友香	kusano_tomoka@example.com
千田 仁	sennda_jin@example.com
上村 拓郎	uemura_takurou@example.com
小林 芳正	kobayashi_yoshimasa@example.com
窪塚 恵麻	kuboduka_ema@example.com
土谷 さとみ	tsuchiya_satomi@example.com
内野 春樹	uchino_haruki@example.com
武 浩正	take_hiromasa@example.com
平良 寿々花	hirara_suzuka@example.com
藤川 晋也	fujikawa_shinya@example.com
長野 精児	nagano_seiji@example.com
花岡 了	hanaoka_ryou@example.com
高柳 俊二	takayanagi_shunji@example.com
神崎 満	kannzaki_mitsuru@example.com
窪田 さやか	kubota_sayaka@example.com
田端 裕司	tabata_yuuji@example.com
岡野 秀隆	okano_hidetaka@example.com
木戸 光	kido_hikaru@example.com
柴咲 優	shibasaki_yuu@example.com
沢尻 雄太	sawajiri_yuuta@example.com
塩谷 那奈	shioya_nana@example.com
白木 美希	shiraki_miki@example.com
秋山 真一	akiyama_shinichi@example.com
早川 朝陽	hayakawa_asahi@example.com
唐沢 仁	karasawa_jin@example.com
浦野 亮	urano_ryou@example.com
武 美佳	take_mika@example.com
真田 啓介	sanada_keisuke@example.com
三井 慢太郎	mitsui_mantarou@example.com
成海 友以乃	narumi_yuino@example.com
佐竹 杏	satake_ann@example.com
中岡 優	nakaoka_yuu@example.com
日下部 恵子	kusakabe_keiko@example.com
神保 莉緒	jinbo_rio@example.com
小森 礼子	komori_reiko@example.com
三枝 さやか	sannshi_sayaka@example.com
渡部 りえ	watabe_rie@example.com
相沢 昴	aizawa_subaru@example.com
南部 美希	nannbu_miki@example.com
安倍 涼	abe_ryou@example.com
中園 右京	nakazono_ukyou@example.com
春日 めぐみ	kasuga_megumi@example.com
若杉 陽子	wakasugi_youko@example.com
坂田 豊	sakata_yutaka@example.com
森谷 詩織	moriya_shiori@example.com
福士 俊介	fukushi_shunsuke@example.com
伊東 ひかり	itou_hikari@example.com
堀田 聖陽	hotta_masaaki@example.com
杉本 完爾	sugimoto_kanji@example.com
佐竹 麻緒	satake_mao@example.com
長瀬 真吾	nagase_shingo@example.com
正木 宏	masaki_hiroshi@example.com
長谷川 フミヤ	hasegawa_fumiya@example.com
村井 哲平	murai_teppei@example.com
保坂 ひとり	hosaka_hitori@example.com
森川 智花	morikawa_tomoka@example.com
井手 和之	ide_kazuyuki@example.com
首藤 美里	sudou_miri@example.com
藤 育二	fuji_ikuji@example.com
境 瞬	sakai_shun@example.com
堀内 恵麻	horiuchi_ema@example.com
岡田 ちえみ	okada_chiemi@example.com
半田 貴美子	hannda_kimiko@example.com
一木 真奈美	ichiki_manami@example.com
金森 璃奈子	kanamori_rinako@example.com
照井 了	terui_ryou@example.com
島村 三省	shimamura_sansei@example.com
伊崎 璃奈子	isaki_rinako@example.com
杉本 あや子	sugimoto_ayako@example.com
大後 えみ	oogo_emi@example.com
酒井 貴美子	sakai_kimiko@example.com
山内 薫	yamauchi_kaoru@example.com
井川 碧海	igawa_ouga@example.com
根岸 賢二	negishi_kenji@example.com
北川 真帆	kitagawa_maho@example.com
安達 陽介	adachi_yousuke@example.com
中原 彩	nakahara_aya@example.com
海老原 佳乃	ebihara_yoshino@example.com
玉山 草太	tamayama_souta@example.com
多田 美紀	tada_miki@example.com
小堀 一徳	kohori_ittoku@example.com
荻原 なつみ	hagiwara_natsumi1@example.com
松澤 綾女	matsuzawa_ayame@example.com
早坂 仁	hayasaka_jin@example.com
市川 正義	ichikawa_masayoshi@example.com
北 なつみ	kita_natsumi@example.com
村木 優	muraki_yuu@example.com
下田 文世	shimoda_fumiyo@example.com
長尾 裕司	nagao_yuuji@example.com
内田 菜摘	uchida_natsumi@example.com
松澤 竜也	matsuzawa_tatsuya1@example.com
関根 ひろみ	sekine_hiromi@example.com
平井 愛梨	hirai_airi@example.com
大崎 俊二	oosaki_shunji@example.com
石垣 康文	ishigaki_yasufumi@example.com
赤坂 璃奈子	akasaka_rinako@example.com
新田 祐一	arata_yuuichi@example.com
堀 将也	hori_masaya@example.com
柴崎 努	shibazaki_tsutomu@example.com
大森 恵麻	oomori_ema@example.com
伊崎 陽介	isaki_yousuke@example.com
片桐 和香	katagiri_waka@example.com
五大 咲	godai_saki@example.com
高野 礼子	takano_reiko@example.com
高島 サンタマリア	takashima_stmaria@example.com
阿部 長利	abe_nagatoshi@example.com
平山 優	hirayama_yuu@example.com
高木 真悠子	takagi_mayuko@example.com
浜野 利夫	hamano_toshio@example.com
大泉 友也	ooizumi_tomoya@example.com
相田 敏和	aida_toshikazu@example.com
三浦 ひとり	miura_hitori@example.com
森口 三省	moriguchi_sansei@example.com
高島 瞬	takashima_shun@example.com
高瀬 剛基	takase_yoshiki@example.com
塩谷 愛子	shiotani_aiko@example.com
松元 めぐみ	matsumoto_megumi@example.com
吉崎 満	yoshizaki_mitsuru@example.com
秋山 あき	akiyama_aki@example.com
菅原 恵麻	sugawara_ema@example.com
松岡 まさし	matsuoka_masashi@example.com
安井 秀樹	yasui_hideki@example.com
早坂 遥	hayasaka_haruka@example.com
山村 寿明	yamamura_toshiaki@example.com
酒井 竜也	sakai_tatsuya@example.com
塚田 春樹	tsukada_haruki@example.com
大橋 早紀	oohashi_saki@example.com
富永 朝陽	tominaga_asahi@example.com
奈良 寿々花	nara_suzuka@example.com
山村 みゆき	yamamura_miyuki@example.com
綾小路 陽子	ayanokouji_youko@example.com
笹原 豊	sasahara_yutaka@example.com
正木 杏	masaki_ann@example.com
武田 勇太	takeda_yuuta@example.com
中井 剛基	nakai_yoshiki@example.com
岩佐 璃子	iwasa_riko@example.com
若松 一	wakamatsu_hajime@example.com
村岡 寛	muraoka_hiroshi@example.com
パンツェッタ 仁	panzetta_jin@example.com
小西 コウ	konishi_kou1@example.com
青山 佑	aoyama_tasuku@example.com
河村 惇	kawamura_jun@example.com
篠崎 昌代	shinozaki_masayo@example.com
秋本 広司	akimoto_kouji@example.com
長岡 功補	nagaoka_kousuke@example.com
今田 扶樹	imada_motoki@example.com
下田 浩介	shimoda_kousuke@example.com
松山 那奈	matsuyama_nana@example.com
青木 あさみ	aoki_asami@example.com
藤野 人志	fujino_hitoshi@example.com
寺脇 高史	terawaki_takashi@example.com
榊原 真帆	sakakibara_maho@example.com
大原 達士	oohara_tatsuhito@example.com
松崎 法嗣	matsuzaki_houshi@example.com
下山 美嘉	shimoyama_mika@example.com
青山 寛治	aoyama_kanji@example.com
加瀬 貴美子	kase_kimiko@example.com
米沢 美月	yonezawa_miduki@example.com
熊沢 咲	kumasawa_saki@example.com
長岡 ヒカル	nagaoka_hikaru@example.com
田畑 文世	tabata_fumiyo@example.com
内藤 隆博	naitou_takahiro@example.com
谷本 由樹	tanimoto_yuki@example.com
中島 照生	nakajima_teruo@example.com
永野 智花	nagano_tomoka@example.com
若林 サンタマリア	wakabayashi_stmaria@example.com
島津 慶太	shimadu_keita@example.com
瀬戸内 真一	setouchi_shinichi@example.com
山川 英嗣	yamakawa_hidetsugu@example.com
水川 郁恵	mizukawa_ikue@example.com
森田 あい	morita_ai@example.com
少路 綾女	shouji_ayame@example.com
岡本 隼士	okamoto_shunji@example.com
近藤 恵梨香	kondou_erika@example.com
田中 ひかり	tanaka_hikari@example.com
浅見 きみまろ	asami_kimimaro@example.com
徳重 倫子	tokushige_noriko@example.com
岸田 惇	kishida_atsushi@example.com
吉崎 美佐	yoshizaki_misa@example.com
深沢 竜也	fukazawa_tatsuya@example.com
中原 美佳	nakahara_mika@example.com
金児 優	kaneko_yuu@example.com
橋爪 美咲	hashidume_misaki@example.com
千田 みあ	sennda_mia@example.com
浅見 未來	asami_mirai@example.com
塩見 翔太	shiomi_shouta@example.com
西井 美佳	nishii_mika@example.com
出口 博之	deguchi_hiroyuki@example.com
町田 智花	machida_tomoka@example.com
奥田 芽以	okuda_mei@example.com
堀越 敦	horikoshi_atsushi@example.com
井口 花	iguchi_hana@example.com
滝 美月	taki_miduki@example.com
脇田 博明	wakita_hiroaki@example.com
川島 豊	kawashima_yutaka@example.com
横尾 沙知絵	yokoo_sachie@example.com
植田 明	ueta_akira@example.com
武藤 莉央	mutou_rio@example.com
松永 未來	matsunaga_mirai@example.com
斎藤 菜々美	saitou_nanami@example.com
黒川 禄郎	kurokawa_rokurou@example.com
中根 法子	nakane_noriko@example.com
堀内 美智子	horiuchi_michiko@example.com
高梨 みあ	takanashi_mia@example.com
坪井 勝久	tsuboi_katsuhisa@example.com
玉木 さとみ	tamaki_satomi@example.com
森脇 高史	moriwaki_takashi@example.com
余 璃奈子	yo_rinako@example.com
下田 雅彦	shimoda_masahiko@example.com
滝沢 樹里	takizawa_juri@example.com
松永 麻由子	matsunaga_mayuko@example.com
相沢 翔	aizawa_shou@example.com
村瀬 涼	murase_ryou@example.com
古賀 優一	koga_yuuichi@example.com
岡本 綾女	okamoto_ayame@example.com
蛍原 浩正	hotohara_hiromasa@example.com
寺島 あさみ	terajima_asami@example.com
千葉 人志	chiba_hitoshi@example.com
久保田 美幸	kubota_miyuki@example.com
仲村 友香	nakamura_tomoka@example.com
近藤 米蔵	konndou_yonezou@example.com
後藤 茜	gotou_akane@example.com
佐藤 南朋	satou_nao@example.com
森下 杏	morishita_ann@example.com
長浜 隆博	nagahama_takahiro@example.com
片桐 敏也	katagiri_toshiya@example.com
鳥居 浩太郎	torii_koutarou@example.com
浦田 三省	urata_sansei@example.com
上原 友香	uehara_tomoka@example.com
坂元 沙知絵	sakamoto_sachie@example.com
関根 たまき	sekine_tamaki@example.com
浅見 勇太	asami_yuuta@example.com
小野 郁恵	ono_ikue@example.com
浜崎 一樹	hamasaki_kazuki@example.com
益田 敏和	masuda_toshikazu@example.com
岡本 仁晶	okamoto_hiroaki@example.com
北条 かおり	houjou_kaori@example.com
松山 明	matsuyama_akira@example.com
小松 結衣	komatsu_yui@example.com
吉岡 路子	yoshioka_michiko@example.com
倉田 信吾	kurata_shingo@example.com
飯田 マサカズ	iida_masakazu@example.com
大河内 妃里	ookouchi_yuri@example.com
平川 竜也	hirakawa_tatsuya@example.com
大内 美紀	oouchi_miki@example.com
坂野 一哉	itano_kazuya@example.com
高倉 明日	takakura_meibi@example.com
大西 はるみ	oonishi_harumi1@example.com
永島 莉沙	nagashima_risa@example.com
矢野 仁晶	yano_hiroaki@example.com
加藤 遥	katou_haruka1@example.com
小日向 美紀	kohinata_miki@example.com
宇多田 俊介	utada_shunsuke@example.com
江崎 ひろみ	ezaki_hiromi@example.com
柴崎 ケンイチ	shibazaki_kenichi@example.com
熊井 輝信	kumai_akinobu@example.com
小田 陽子	oda_youko@example.com
久保 なつみ	kubo_natsumi@example.com
阪本 龍吉	sakamoto_ryuukichi@example.com
藤田 龍吉	fujita_ryuukichi@example.com
平沢 広之	hirasawa_hiroyuki@example.com
寺尾 莉央	terao_rio1@example.com
竹中 育二	takenaka_ikuji@example.com
恩田 染五郎	onnda_somegorou@example.com
本田 耕司	honnda_kouji@example.com
楠 崇史	kusunoki_takashi@example.com
阪本 蒼甫	sakamoto_sousuke@example.com
江口 兼	eguchi_ken@example.com
三宅 めぐみ	miyake_megumi@example.com
浜田 弘也	hamada_hironari@example.com
戸田 沙耶	toda_saya@example.com
岡山 幸子	okayama_sachiko@example.com
南 ひとり	minami_hitori@example.com
高島 隆太	takashima_ryuuta@example.com
山田 誠治	yamada_seiji@example.com
山田 寿々花	yamada_suzuka@example.com
柳田 遥	yanagida_haruka@example.com
三橋 裕次郎	mihashi_yuujirou@example.com
劇団 ジローラモ	gekidan_girolamo@example.com
石野 佳乃	ishino_yoshino@example.com
成瀬 綾女	naruse_ayame@example.com
水口 草太	mizuguchi_souta@example.com
平田 人志	hirata_hitoshi@example.com
松下 雅彦	matsushita_masahiko@example.com
富山 満	tomiyama_mitsuru@example.com
田上 基祐	taue_kisuke@example.com
亀井 隆太	kamei_ryuuta@example.com
恩田 沙耶	onnda_saya@example.com
片岡 さんま	kataoka_sanma@example.com
森川 かおり	morikawa_kaori@example.com
杉本 菜摘	sugimoto_natsumi@example.com
竹村 建	takemura_ken@example.com
園田 信吾	sonoda_shingo@example.com
角田 健	kadota_ken@example.com
下山 秀樹	shimoyama_hideki@example.com
梅村 右京	umemura_ukyou@example.com
対馬 勇介	tsushima_yuusuke@example.com
吉岡 一輝	yoshioka_kazuki@example.com
菅澤 さとみ	sugasawa_satomi@example.com
津田 草太	tsuda_souta1@example.com
石井 くるみ	ishii_kurumi@example.com
神戸 慢太郎	koube_mantarou@example.com
中園 建	nakazono_ken@example.com
今 璃子	kon_riko@example.com
小谷 優	kotani_yuu@example.com
堀川 竜也	horikawa_tatsuya@example.com
池内 敦	ikeuchi_atsushi@example.com
江原 めぐみ	ehara_megumi@example.com
今村 菊生	imamura_kikuo@example.com
竹内 勝久	takeuchi_katsuhisa@example.com
黒川 大	kurokawa_masaru@example.com
小宮 充則	komiya_mitsunori@example.com
小池 ジョージ	koike_george@example.com
武井 恵望子	takei_emiko@example.com
梅原 直人	umehara_naoto@example.com
西浦 めぐみ	nishiura_megumi@example.com
浅野 浩正	asano_hiromasa@example.com
菅沼 早紀	suganuma_saki@example.com
小田島 洋	odajima_you@example.com
志村 祐基	shimura_yuuki@example.com
染谷 祐一	someya_yuuichi@example.com
青山 千佳子	aoyama_chikako@example.com
細谷 知世	hosoya_chise@example.com
飯田 那奈	iida_nana@example.com
五大 エリカ	godai_erika@example.com
田村 真悠子	tamura_mayuko@example.com
野村 さとみ	nomura_satomi@example.com
若山 建	wakayama_ken@example.com
大竹 圭	ootake_kei@example.com
石黒 怜奈	ishiguro_reina@example.com
福永 竜也	fukunaga_tatsuya@example.com
三村 なぎさ	mimura_nagisa@example.com
ほしの 勝久	hoshino_katsuhisa@example.com
梅田 人志	umeda_hitoshi@example.com
吹越 祐一	fukikoshi_yuuichi@example.com
小室 信輔	komuro_shinsuke@example.com
井沢 ひろ子	izawa_hiroko@example.com
鈴木 賢二	suzuki_kenji@example.com
佐々木 茂樹	sasaki_shigeki@example.com
新井 将也	arai_masaya@example.com
難波 完爾	nannba_kanji1@example.com
篠山 秀樹	shinoyama_hideki@example.com
寺脇 りえ	terawaki_rie@example.com
福地 美幸	fukuchi_miyuki@example.com
石黒 麻緒	ishiguro_mao@example.com
志村 一	shimura_hajime@example.com
大浦 奈月	ooura_natsuki@example.com
若槻 早織	wakatsuki_saori@example.com
相武 利夫	aibu_toshio@example.com
浦田 昌代	urata_masayo@example.com
森下 美咲	morishita_misaki@example.com
松浦 ひろ子	matsuura_hiroko@example.com
武田 樹里	takeda_juri@example.com
久保田 紗季	kubota_saki@example.com
生田 淳	namata_atsushi@example.com
島村 真吾	shimamura_shingo@example.com
竹内 奈月	takeuchi_natsuki@example.com
内村 友以乃	uchimura_yuino@example.com
ユースケ 仁	yusuke_jin@example.com
藤岡 恵梨香	fujioka_erika@example.com
藤 美佐	fuji_misa@example.com
飛田 茜	hida_akane@example.com
富沢 隆	tomisawa_takashi@example.com
黒川 昌代	kurokawa_masayo@example.com
宮川 慶太	miyakawa_keita@example.com
中川 桃子	nakagawa_momoko@example.com
大後 美月	oogo_miduki@example.com
沢田 奈月	sawada_natsuki@example.com
大沢 雅之	oosawa_masayuki@example.com
南部 あい	nannbu_ai@example.com
芦田 一輝	ashida_kazuki@example.com
大竹 愛菜	ootake_aina@example.com
大和田 真一	oowada_shinichi@example.com
湊 幸平	minato_kouhei@example.com
松居 雅彦	matsui_masahiko@example.com
三上 明	mikami_akira@example.com
釈 雅彦	shaku_masahiko@example.com
小谷 雅之	kotani_masayuki@example.com
神山 晋也	kamiyama_shinya@example.com
稲葉 誠治	inaba_seiji@example.com
小田島 彩	odajima_aya@example.com
平田 倫子	hirata_noriko@example.com
七瀬 綾	nanase_aya@example.com
唐沢 杏	karasawa_ann@example.com
岸本 敏也	kishimoto_toshiya@example.com
田上 慶二	taue_keiji@example.com
岩城 美菜	iwaki_mina@example.com
本多 敏也	honnda_toshiya@example.com
藤村 正敏	fujimura_masatoshi@example.com
西沢 倫子	nishizawa_noriko@example.com
原 一徳	hara_ittoku@example.com
須賀 怜奈	suga_reina@example.com
岡田 貴嶺	okada_takane@example.com
岸 美里	kishi_miri@example.com
藤井 豊	fujii_yutaka@example.com
大滝 薫	ootaki_kaoru@example.com
泉 だん吉	izumi_dankichi@example.com
瀬川 哲平	segawa_teppei@example.com
堀越 郁恵	horikoshi_ikue@example.com
牧野 有海	makino_ami@example.com
井川 恵美	igawa_megumi@example.com
榊原 貴美子	sakakibara_kimiko@example.com
日下 杏	hinoshita_ann@example.com
金井 佳乃	kanai_yoshino@example.com
浅沼 剛基	asanuma_yoshiki@example.com
奥村 華子	okumura_hanako@example.com
宮迫 三省	miyasako_sansei@example.com
木村 そら	kimura_sora@example.com
西尾 メイサ	nishio_meisa@example.com
今 照生	ima_teruo@example.com
藤島 咲	fujishima_saki@example.com
畑 菊生	hatake_kikuo@example.com
坂上 雅彦	sakagami_masahiko@example.com
中村 ヒカル	nakamura_hikaru@example.com
岩村 功補	iwamura_kousuke@example.com
竹田 晴臣	takeda_haruomi@example.com
狩野 亮	kano_ryou@example.com
東 優	higashi_yuu1@example.com
金森 由宇	kanamori_yuu@example.com
妻夫木 ノブヒコ	tsumabuki_nobuhiko@example.com
内村 雅彦	uchimura_masahiko@example.com
守屋 瞬	moriya_shun1@example.com
桜井 光臣	sakurai_mitsuomi@example.com
相沢 友香	aizawa_tomoka@example.com
金井 雅彦	kanai_masahiko@example.com
宮下 そら	miyashita_sora@example.com
堀 健	hori_ken@example.com
横井 六郎	yokoi_rokurou@example.com
杉村 結衣	sugimura_yui@example.com
小沼 雅功	konuma_masatoshi@example.com
本村 そら	honnmura_sora@example.com
久野 克実	hisano_katsumi@example.com
合田 光	aida_hikaru@example.com
飯塚 慶太	iiduka_keita@example.com
藤野 美嘉	fujino_mika@example.com
柳 祐一	yanagi_yuuichi@example.com
増田 功補	masuda_kousuke@example.com
神山 瞬	kamiyama_shun@example.com
小泉 憲一	koizumi_kenichi@example.com
矢口 一徳	yaguchi_ittoku@example.com
土井 弘也	doi_hironari@example.com
二宮 淳子	ninomiya_atsuko@example.com
川本 充則	kawamoto_mitsunori@example.com
小町 路子	komachi_michiko@example.com
福田 妃里	fukuda_yuri@example.com
平山 秀樹	hirayama_hideki@example.com
福地 慶太	fukuchi_keita@example.com
芦屋 勇介	ashiya_yuusuke@example.com
伊集院 季衣	ijuuin_toshie@example.com
秋元 徹	akimoto_tooru@example.com
野島 早紀	nojima_saki1@example.com
安部 洋	abe_you@example.com
福田 ひとみ	fukuda_hitomi@example.com
岩永 惇	iwanaga_jun@example.com
江口 遥	eguchi_haruka@example.com
前田 ヒカル	maeda_hikaru@example.com
横尾 寿明	yokoo_toshiaki@example.com
飛田 璃子	hida_riko@example.com
小高 かおり	kodaka_kaori@example.com
山内 たまき	yamanouchi_tamaki@example.com
風間 路子	kazama_michiko@example.com
牧田 禄郎	makita_rokurou@example.com
野崎 コウ	nozaki_kou@example.com
田口 杏	taguchi_ann@example.com
高原 恵梨香	takahara_erika@example.com
飯田 真奈美	iida_manami@example.com
長沢 仁晶	nagasawa_hiroaki@example.com
田中 基祐	tanaka_kisuke@example.com
富永 竜次	tominaga_ryuuji@example.com
辻 惇	tsuji_atsushi@example.com
宮下 幸平	miyashita_kouhei@example.com
萩原 宏行	hagiwara_hiroyuki@example.com
布施 知史	fuse_tomofumi@example.com
猪股 三郎	inomata_saburou@example.com
鹿手袋 宏	shikatebukuro_hiroshi@example.com
徳重 充則	tokushige_mitsunori@example.com
長谷 そら	nagaya_sora@example.com
坂本 きみまろ	sakamoto_kimimaro@example.com
河合 佑	kawai_tasuku@example.com
大城 あおい	ooshiro_aoi@example.com
峰 あさみ	mine_asami@example.com
近藤 瞳	konndou_hitomi@example.com
奥 美月	oku_miduki@example.com
森口 恵子	moriguchi_keiko@example.com
寺島 研二	terashima_kenji@example.com
柴田 一輝	shibata_kazuki@example.com
神原 莉緒	kannbara_rio@example.com
沢田 竜次	sawada_ryuuji@example.com
松岡 一恵	matsuoka_kadue@example.com
本上 麻緒	honjo_mao@example.com
雨宮 美月	amamiya_miduki@example.com
中原 公顕	nakahara_kimiaki@example.com
渡辺 信吾	watanabe_shingo@example.com
今 寿明	kon_toshiaki@example.com
前田 染五郎	maeda_somegorou@example.com
若山 友香	wakayama_tomoka@example.com
境 涼	sakai_ryou@example.com
鈴木 フミヤ	suzuki_fumiya@example.com
神野 雅之	kamino_masayuki@example.com
滝口 友也	takiguchi_tomoya@example.com
坂口 弘也	sakaguchi_hironari@example.com
日下 佳乃	hinoshita_yoshino@example.com
千葉 みあ	chiba_mia@example.com
平田 麻由子	hirata_mayuko@example.com
満島 一徳	mitsushima_ittoku@example.com
石坂 さんま	ishizaka_sanma@example.com
森 和久	mori_kazuhisa@example.com
柴山 恵梨香	shibayama_erika@example.com
山上 ひろみ	yamagami_hiromi@example.com
小沼 恵子	konuma_keiko@example.com
吉村 瞬	yoshimura_shun@example.com
石黒 直人	ishiguro_naoto@example.com
高橋 一樹	takahashi_kazuki@example.com
滝本 コウ	takimoto_kou@example.com
坂本 薫	sakamoto_kaoru2@example.com
新垣 友也	niigaki_tomoya@example.com
高畑 サンタマリア	takahata_stmaria@example.com
長澤 勝久	nagasawa_katsuhisa@example.com
梅沢 茜	umezawa_akane@example.com
那須 仁晶	nasu_hiroaki@example.com
森田 光博	morita_mitsuhiro@example.com
木本 あおい	kimoto_aoi@example.com
麻生 真吾	asou_shingo@example.com
小野 一恵	ono_kadue@example.com
豊田 まひる	toyota_mahiru@example.com
遠山 恭子	tooyama_kyouko@example.com
河原 佳乃	kawahara_yoshino@example.com
氏家 建	ujiie_ken@example.com
平沢 妃里	hirasawa_yuri@example.com
河内 慶太	kawauchi_keita@example.com
市川 雄太	ichikawa_yuuta@example.com
井村 璃子	imura_riko@example.com
福田 ケンイチ	fukuda_kenichi@example.com
久保田 敦	kubota_atsushi@example.com
丸山 満	maruyama_mitsuru@example.com
永島 美幸	nagashima_miyuki@example.com
三原 憲史	mihara_norihito@example.com
磯村 璃奈子	isomura_rinako@example.com
浅倉 恵美	asakura_megumi@example.com
高田 一徳	takada_ittoku@example.com
津田 桃子	tsuda_momoko@example.com
越智 一樹	ochi_kazuki@example.com
仲村 佑	nakamura_tasuku@example.com
池内 真帆	ikeuchi_maho@example.com
永山 愛子	nagayama_aiko@example.com
千田 きみまろ	sennda_kimimaro@example.com
塩沢 そら	shiozawa_sora@example.com
布施 隆	fuse_takashi@example.com
久保 長利	kubo_nagatoshi@example.com
小松 遥	komatsu_haruka@example.com
山西 徹	yamanishi_tooru@example.com
平松 だん吉	hiramatsu_dankichi@example.com
福士 勇太	fukushi_yuuta@example.com
吉岡 三省	yoshioka_sansei@example.com
小口 雅之	oguchi_masayuki@example.com
瀬尾 直人	seo_naoto@example.com
中園 季衣	nakazono_toshie@example.com
工藤 しぼり	kudou_shibori@example.com
坂元 豊	sakamoto_yutaka@example.com
志村 隆博	shimura_takahiro@example.com
島 亜希	shima_aki@example.com
渡部 一樹	watabe_kazuki@example.com
岩下 長利	iwashita_nagatoshi@example.com
多田 ひろ子	tada_hiroko@example.com
永島 満	nagashima_mitsuru@example.com
村瀬 獅童	murase_shidou@example.com
稲葉 麻緒	inaba_mao@example.com
津田 ひとみ	tsuda_hitomi@example.com
土居 路子	doi_michiko1@example.com
茂木 由樹	mogi_yuki@example.com
植村 啓介	uemura_keisuke@example.com
滝 宏	taki_hiroshi@example.com
坂東 竜也	banntou_tatsuya@example.com
戸田 佑	toda_tasuku@example.com
笠原 充則	kasahara_mitsunori@example.com
塩谷 正義	shiotani_masayoshi@example.com
福井 徹平	fukui_teppei@example.com
篠崎 早織	shinozaki_saori@example.com
朝倉 明慶	asakura_akiyoshi@example.com
今田 恭子	imada_kyouko@example.com
池上 あき	ikegami_aki@example.com
山内 丈史	yamauchi_takeshi@example.com
菊池 ケンイチ	kikuchi_kenichi@example.com
土居 友也	doi_tomoya@example.com
吉野 なぎさ	yoshino_nagisa@example.com
福本 芽以	fukumoto_mei@example.com
市川 サンタマリア	ichikawa_stmaria@example.com
加瀬 昌代	kase_masayo@example.com
田口 美希	taguchi_miki@example.com
浅沼 誠一	asanuma_seiichi@example.com
宮本 健	miyamoto_ken@example.com
久米 了	kume_ryou@example.com
鶴田 小百合	tsuruta_sayuri@example.com
大矢 サンタマリア	ooya_stmaria@example.com
梅原 広之	umehara_hiroyuki@example.com
桜井 一恵	sakurai_kadue@example.com
高原 めぐみ	takahara_megumi@example.com
松永 朝陽	matsunaga_asahi@example.com
奥田 米蔵	okuda_yonezou@example.com
豊島 景子	toyoshima_keiko@example.com
野中 はるか	nonaka_haruka@example.com
綾小路 智花	ayanokouji_tomoka@example.com
江崎 由宇	ezaki_yuu@example.com
船橋 ちえみ	funabashi_chiemi@example.com
山本 俊二	yamamoto_shunji@example.com
今泉 研二	imaizumi_kenji@example.com
森井 千夏	morii_chinatsu@example.com
松山 朝香	matsuyama_asaka@example.com
片桐 たまき	katagiri_tamaki@example.com
中本 奈月	nakamoto_natsuki@example.com
平山 れいな	hirayama_reina@example.com
内野 祐基	uchino_yuuki@example.com
草村 奈々	kusamura_nana@example.com
川井 寿々花	kawai_suzuka@example.com
寺田 知史	terada_tomofumi@example.com
森 友以乃	mori_yuino@example.com
甲斐 信輔	kai_shinsuke@example.com
川瀬 恵梨香	kawase_erika@example.com
岩田 聖陽	iwata_masaaki@example.com
柳 貴美子	yanagi_kimiko@example.com
野島 雅功	nojima_masatoshi@example.com
立川 ノブヒコ	tachikawa_nobuhiko@example.com
本間 未來	honma_mirai@example.com
関根 真帆	sekine_maho@example.com
大河内 宏	ookouchi_hiroshi@example.com
藤村 洋	fujimura_you@example.com
戸田 敦	toda_atsushi@example.com
堀江 真吾	horie_shingo@example.com
ト字 育子	toji_ikuko@example.com
秋本 一輝	akimoto_kazuki@example.com
本山 明	honnyama_akira@example.com
塚原 良介	tsukahara_ryousuke@example.com
丹羽 未來	tannba_mirai@example.com
星 エリカ	hoshi_erika@example.com
松山 小百合	matsuyama_sayuri@example.com
柳原 大五郎	yanagihara_daigorou@example.com
大場 優	ooba_yuu1@example.com
原 美嘉	hara_mika@example.com
大西 賢二	oonishi_kenji@example.com
大川 はじめ	ookawa_hajime@example.com
井川 遥	igawa_haruka@example.com
土橋 メイサ	tsuchihashi_meisa@example.com
町田 長利	machida_nagatoshi@example.com
宮本 直人	miyamoto_naoto@example.com
大和田 瑠璃亜	oowada_ruria@example.com
北野 寛治	kitano_kanji@example.com
水川 公顕	mizukawa_kimiaki@example.com
大路 隆之介	ooji_ryuunosuke@example.com
緒方 詩織	ogata_shiori@example.com
矢田 理紗	yada_risa@example.com
手塚 聖陽	teduka_masaaki@example.com
松田 亮	matsuda_ryou@example.com
大河内 早織	ookouchi_saori@example.com
皆川 なつみ	minakawa_natsumi@example.com
平尾 愛梨	hirao_airi@example.com
柴咲 麻由子	shibasaki_mayuko1@example.com
坂東 憲史	banntou_norihito@example.com
伊藤 友也	itou_tomoya@example.com
松下 憲史	matsushita_norihito@example.com
岡山 竜也	okayama_tatsuya@example.com
浅川 秀隆	asakawa_hidetaka@example.com
北村 翔太	kitamura_shouta@example.com
植松 俊介	uematsu_shunsuke@example.com
城咲 浩介	shirosaki_kousuke@example.com
白石 さんま	shiraishi_sanma@example.com
田原 健	tahara_ken@example.com
福岡 ケンイチ	fukuoka_kenichi@example.com
綾瀬 知史	ayase_tomofumi@example.com
城田 三省	shirota_sansei@example.com
今泉 杏	imaizumi_ann@example.com
坂元 剛基	sakamoto_yoshiki@example.com
吉原 結子	yoshiwara_yuuko@example.com
秋元 美佐	akimoto_misa@example.com
井川 小雁	igawa_kogan@example.com
大庭 優	ooniwa_yuu@example.com
布川 明日	fukawa_meibi@example.com
坂上 照生	sakagami_teruo@example.com
新田 有海	arata_ami@example.com
三橋 恵子	mihashi_keiko@example.com
松原 雅彦	matsubara_masahiko@example.com
相原 薫	aihara_kaoru@example.com
浅利 裕司	asari_yuuji@example.com
塚本 惇	tsukamoto_jun@example.com
大江 太朗	ooe_tarou@example.com
竹村 季衣	takemura_toshie@example.com
角 充則	sumi_mitsunori@example.com
松原 コウ	matsubara_kou@example.com
深谷 早織	fukaya_saori@example.com
岩佐 草太	iwasa_souta1@example.com
宮崎 直人	miyazaki_naoto@example.com
中川 惇	nakagawa_jun@example.com
栗田 勇	kurita_yuu@example.com
城田 祐一	shirota_yuuichi1@example.com
中原 裕次郎	nakahara_yuujirou@example.com
平塚 光良	hiratsuka_teruyoshi@example.com
榊原 さとみ	sakakibara_satomi@example.com
野中 俊二	nonaka_shunji@example.com
角谷 綾女	kadotani_ayame@example.com
滝口 美優	takiguchi_myuu@example.com
安井 早織	yasui_saori@example.com
片平 紗季	katahira_saki@example.com
柳田 詩織	yanagida_shiori@example.com
唐沢 めぐみ	karasawa_megumi@example.com
北 あい	kita_ai@example.com
高畑 敏也	takabata_toshiya@example.com
伊藤 勤	itou_tsutomu@example.com
原口 育子	haraguchi_ikuko@example.com
浜本 豊	hamamoto_yutaka@example.com
下村 由樹	shimomura_yuki@example.com
中尾 慢太郎	nakao_mantarou@example.com
堤 亮介	tsutsumi_ryousuke@example.com
中島 人志	nakashima_hitoshi@example.com
豊島 瞳	toyoshima_hitomi@example.com
磯部 真希	isobe_maki@example.com
有田 倫子	arita_noriko@example.com
成海 和之	narumi_kazuyuki@example.com
平賀 ひろみ	hiraga_hiromi@example.com
寺西 貴嶺	teranishi_takane@example.com
柳原 獅童	yanagihara_shidou@example.com
西原 なつみ	nishihara_natsumi@example.com
横川 晃司	yokokawa_kouji@example.com
森山 豊	moriyama_yutaka@example.com
榎本 裕次郎	enomoto_yuujirou@example.com
森島 京子	morishima_kyouko@example.com
深沢 隆太	fukazawa_ryuuta@example.com
片桐 右京	katagiri_ukyou@example.com
大泉 竜也	ooizumi_tatsuya@example.com
益田 友也	masuda_tomoya@example.com
森山 正義	moriyama_masayoshi@example.com
本間 奈々	honma_nana@example.com
板橋 勇	itabashi_yuu@example.com
田上 沙耶	taue_saya@example.com
千葉 由美子	chiba_yumiko@example.com
竹中 麻緒	takenaka_mao@example.com
山崎 桃子	yamazaki_momoko@example.com
橋本 玲那	hashimoto_rena@example.com
南 有起哉	minami_yukiya@example.com
本間 沙知絵	honma_sachie@example.com
金子 遥	kaneko_haruka@example.com
葛山 さやか	katsurayama_sayaka@example.com
高橋 薫	takahashi_kaoru@example.com
北条 希	houjou_nozomi@example.com
早美 だん吉	hayami_dankichi@example.com
梅本 瞬	umemoto_shun@example.com
とよた さやか	toyota_sayaka@example.com
川原 雅之	kawahara_masayuki@example.com
富田 花	tomita_hana@example.com
坂本 恭子	sakamoto_kyouko@example.com
森脇 右京	moriwaki_ukyou@example.com
小島 隆太	kojima_ryuuta@example.com
阪口 みあ	sakaguchi_mia@example.com
中谷 真希	nakatani_maki@example.com
ほしの 了	hoshino_ryou@example.com
斉藤 大	saitou_masaru@example.com
緒方 慶二	ogata_keiji@example.com
早川 徹	hayakawa_tooru@example.com
村田 建	murata_ken@example.com
岩谷 春樹	iwatani_haruki@example.com
宮崎 法嗣	miyazaki_houshi@example.com
浜田 育子	hamada_ikuko@example.com
津田 一徳	tsuda_ittoku@example.com
奥野 寿々花	okuno_suzuka@example.com
黒谷 光	kurotani_hikaru@example.com
長谷川 大樹	hasegawa_hiroki@example.com
山口 文世	yamaguchi_fumiyo@example.com
草野 沙知絵	kusano_sachie@example.com
本村 涼子	honnmura_ryouko@example.com
柳川 寿々花	yanagawa_suzuka@example.com
大高 惇	oodaka_atsushi@example.com
内村 染五郎	uchimura_somegorou@example.com
大村 涼子	oomura_ryouko@example.com
木原 コウ	kihara_kou@example.com
永山 ひかり	nagayama_hikari@example.com
千葉 ひとり	chiba_hitori@example.com
岩永 聡	iwanaga_satoshi@example.com
新村 麻由子	niimura_mayuko@example.com
黒木 勝久	kuroki_katsuhisa@example.com
横尾 夏空	yokoo_sora@example.com
関根 染五郎	sekine_somegorou@example.com
鬼頭 希	kitou_nozomi@example.com
瀬川 優	segawa_yuu@example.com
松岡 さとみ	matsuoka_satomi@example.com
堀 れいな	hori_reina@example.com
伊丹 裕司	itami_yuuji@example.com
浜 綾女	hama_ayame@example.com
岩佐 兼	iwasa_ken@example.com
関 一樹	seki_kazuki@example.com
堤 なつみ	tsutsumi_natsumi@example.com
秋田 育子	akita_ikuko1@example.com
福井 美菜	fukui_mina@example.com
藤野 仁	fujino_jin@example.com
神崎 敏和	kannzaki_toshikazu@example.com
村田 竜也	murata_tatsuya@example.com
松岡 美月	matsuoka_miduki@example.com
手塚 優一	teduka_yuuichi@example.com
五大 友以乃	godai_yuino@example.com
井口 勝久	iguchi_katsuhisa@example.com
吉永 あき	yoshinaga_aki@example.com
小松 あや子	komatsu_ayako@example.com
亀山 遥	kameyama_haruka1@example.com
大坪 恵梨香	ootsubo_erika@example.com
阿久津 陽子	akutsu_youko@example.com
辻本 はるか	tsujimoto_haruka@example.com
釈 なつみ	shaku_natsumi@example.com
黒田 沙知絵	kurota_sachie@example.com
岸田 みゆき	kishida_miyuki@example.com
黒岩 友以乃	kuroiwa_yuino@example.com
矢島 ひかり	yajima_hikari@example.com
津田 六郎	tsuda_rokurou@example.com
藤森 洋介	fujimori_yousuke@example.com
児玉 奈月	kodama_natsuki@example.com
奥村 由宇	okumura_yuu1@example.com
今泉 仁	imaizumi_jin@example.com
足立 菜摘	adachi_natsumi@example.com
浜崎 隆太	hamasaki_ryuuta@example.com
田村 裕司	tamura_yuuji@example.com
綾瀬 悟志	ayase_satoshi@example.com
中根 昴	nakane_subaru@example.com
藤澤 一徳	fujisawa_ittoku@example.com
筒井 あおい	tsutsui_aoi@example.com
品川 俊二	shinagawa_shunji@example.com
草野 広之	kusano_hiroyuki@example.com
小寺 奈月	kodera_natsuki@example.com
寺島 なつみ	terashima_natsumi@example.com
大石 えみ	ooishi_emi@example.com
瀬尾 大樹	seo_hiroki@example.com
小柳 えみ	koyanagi_emi@example.com
古沢 正敏	furusawa_masatoshi@example.com
木内 長利	kiuchi_nagatoshi@example.com
西野 聡	nishino_satoshi@example.com
小畑 和久	obata_kazuhisa1@example.com
有馬 蒼甫	arima_sousuke@example.com
関根 恵望子	sekine_emiko@example.com
池畑 恵梨香	ikehata_erika@example.com
大森 杏	oomori_ann@example.com
高野 さやか	takano_sayaka@example.com
高野 明宏	takano_akihiro@example.com
阿部 浩太郎	abe_koutarou@example.com
小玉 宏	kodama_hiroshi@example.com
大原 サンタマリア	oohara_stmaria@example.com
芹沢 季衣	serizawa_toshie@example.com
塚田 あき	tsukada_aki@example.com
神原 綾	kannbara_aya@example.com
安永 あき	yasunaga_aki@example.com
五大 ヒロ	godai_hiro@example.com
若槻 惇	wakatsuki_atsushi@example.com
福岡 恵梨香	fukuoka_erika@example.com
須藤 恭子	sudou_kyouko1@example.com
村松 朝香	muramatsu_asaka@example.com
根本 剛基	nemoto_yoshiki@example.com
松木 くるみ	matsuki_kurumi@example.com
中園 誠一	nakazono_seiichi@example.com
川原 たまき	kawahara_tamaki@example.com
八木 勇太	yagi_yuuta@example.com
安倍 陽介	abe_yousuke@example.com
菅澤 千夏	sugasawa_chinatsu@example.com
小沢 誠一	ozawa_seiichi@example.com
福沢 裕司	fukuzawa_yuuji@example.com
勝地 ケンイチ	katsudi_kenichi@example.com
及川 早織	oikawa_saori@example.com
藤原 礼子	fujiwara_reiko@example.com
柴山 竜也	shibayama_tatsuya@example.com
大泉 美佐	ooizumi_misa@example.com
村松 みゆき	muramatsu_miyuki@example.com
谷村 恵子	tanimura_keiko@example.com
丸田 咲	maruta_saki@example.com
高見 充則	takami_mitsunori@example.com
吹石 長利	fukiishi_nagatoshi@example.com
立川 育二	tachikawa_ikuji@example.com
倉持 桃子	kuramochi_momoko@example.com
高岡 晃司	takaoka_kouji1@example.com
有田 ひろみ	arita_hiromi@example.com
奥 俊二	oku_shunji@example.com
内藤 涼子	naitou_ryouko@example.com
山内 栄一	yamanouchi_eiichi@example.com
浜田 恵子	hamada_keiko@example.com
山本 恵麻	yamamoto_ema@example.com
下川 美佳	shimokawa_mika@example.com
柏原 七世	kashiwara_nanase@example.com
金児 あや子	kaneko_ayako@example.com
塚本 里穂	tsukamoto_riho@example.com
竹中 杏	takenaka_ann@example.com
須藤 一輝	sudou_kazuki@example.com
大畑 莉央	oohata_rio@example.com
菅谷 仁晶	sugaya_hiroaki@example.com
荒木 昴	araki_subaru@example.com
馬場 一	baba_hajime@example.com
横田 薫	yokota_kaoru@example.com
北田 美嘉	kitada_mika@example.com
平沢 茂樹	hirasawa_shigeki@example.com
照井 人志	terui_hitoshi@example.com
小沼 精児	konuma_seiji@example.com
大竹 憲史	ootake_norihito@example.com
玉城 誠一	tamaki_seiichi@example.com
ユースケ 遥	yusuke_haruka@example.com
本山 景子	honnyama_keiko@example.com
阪本 夏希	sakamoto_natsuki@example.com
小玉 公顕	kodama_kimiaki@example.com
竹原 仁晶	takehara_hiroaki@example.com
大高 郁恵	oodaka_ikue@example.com
富岡 怜奈	tomioka_reina@example.com
大谷 希	ootani_nozomi@example.com
石坂 碧海	ishizaka_ouga@example.com
内野 涼	uchino_ryou@example.com
楠本 しぼり	kusumoto_shibori@example.com
佐古 まさみ	sako_masami@example.com
小市 くるみ	koichi_kurumi@example.com
丹羽 隼士	tannba_shunji@example.com
島袋 恵子	shimabukuro_keiko@example.com
田口 秀隆	taguchi_hidetaka@example.com
三井 秀隆	mitsui_hidetaka@example.com
関根 美幸	sekine_miyuki@example.com
鈴木 一	suzuki_hajime@example.com
河野 正敏	kouno_masatoshi@example.com
西野 京子	nishino_kyouko@example.com
高山 まひる	takayama_mahiru@example.com
佐古 杏	sako_ann@example.com
小松 美希	komatsu_miki@example.com
武田 綾	takeda_aya@example.com
江崎 勤	ezaki_tsutomu@example.com
黒沢 獅童	kurosawa_shidou@example.com
小松 法子	komatsu_noriko@example.com
早美 朝陽	hayami_asahi@example.com
原 まひる	hara_mahiru@example.com
伊沢 一代	izawa_kazuyo1@example.com
小田島 まひる	odajima_mahiru@example.com
奥田 さゆり	okuda_sayuri@example.com
浅田 満	asada_mitsuru@example.com
永田 新太	nagata_arata@example.com
滝口 美月	takiguchi_miduki@example.com
赤羽 夏空	akabane_sora@example.com
田淵 勇	tabuchi_yuu@example.com
奥寺 結子	okudera_yuuko@example.com
三浦 真奈美	miura_manami@example.com
吉井 優	yoshii_yuu@example.com
熊井 菜々美	kumai_nanami@example.com
佐竹 誠治	satake_seiji@example.com
早美 七世	hayami_nanase@example.com
有馬 雅彦	arima_masahiko@example.com
高田 早紀	takada_saki@example.com
近藤 璃子	kondou_riko@example.com
前田 美里	maeda_miri@example.com
有馬 亜希	arima_aki@example.com
梅津 めぐみ	umedu_megumi@example.com
辻本 薫	tsujimoto_kaoru@example.com
大沢 勇太	oosawa_yuuta@example.com
志村 敦	shimura_atsushi@example.com
小松 瑠璃亜	komatsu_ruria@example.com
綾瀬 哲平	ayase_teppei@example.com
玉城 ジョージ	tamaki_george@example.com
柴田 麻由子	shibata_mayuko@example.com
田端 達士	tabata_tatsuhito@example.com
村井 窈	murai_you@example.com
熊田 惇	kumada_atsushi@example.com
安達 麗奈	adachi_rena@example.com
片岡 朝香	kataoka_asaka@example.com
市原 友香	ichihara_tomoka@example.com
上田 あや子	ueda_ayako@example.com
植村 光	uemura_hikaru1@example.com
吉沢 景子	yoshizawa_keiko@example.com
高野 はるみ	takano_harumi@example.com
野呂 健	noro_ken@example.com
吉永 さやか	yoshinaga_sayaka@example.com
永野 明	nagano_akira@example.com
大野 優	oono_yuu@example.com
北村 裕司	kitamura_yuuji@example.com
小倉 瞬	ogura_shun@example.com
太田 裕次郎	oota_yuujirou@example.com
志水 光臣	shimizu_mitsuomi@example.com
七瀬 雅彦	nanase_masahiko@example.com
会田 砂羽	aida_sawa@example.com
雨宮 理紗	amamiya_risa@example.com
須藤 樹里	sudou_juri1@example.com
本橋 誠治	motohashi_seiji@example.com
奥野 一代	okuno_kazuyo@example.com
岸部 ひろみ	kishibe_hiromi@example.com
中山 恵子	nakayama_keiko@example.com
栗田 芳正	kurita_yoshimasa@example.com
佐伯 那奈	saeki_nana@example.com
武田 遥	takeda_haruka@example.com
都築 仁	tsuduki_jin@example.com
川原 翔太	kawahara_shouta@example.com
滝沢 一徳	takizawa_ittoku@example.com
役所 美智子	yakusho_michiko@example.com
白石 沙知絵	shiraishi_sachie@example.com
松原 隆博	matsubara_takahiro@example.com
石渡 麗奈	ishiwatari_rena@example.com
浜野 恵子	hamano_keiko@example.com
森山 めぐみ	moriyama_megumi@example.com
坂下 愛梨	sakashita_airi@example.com
吉崎 ケンイチ	yoshizaki_kenichi@example.com
奥田 奈月	okuda_natsuki@example.com
浜口 翔子	hamaguchi_shouko@example.com
伊集院 薫	ijuuin_kaoru@example.com
岩淵 さとみ	iwabuchi_satomi@example.com
原 佳乃	hara_yoshino@example.com
志水 誠一	shimizu_seiichi@example.com
山田 広之	yamada_hiroyuki@example.com
宇野 勝久	uno_katsuhisa@example.com
河西 恵梨香	kawanishi_erika@example.com
伊藤 昴	itou_subaru@example.com
益田 知世	masuda_chise@example.com
丸田 美和子	maruta_miwako@example.com
細谷 ヒロ	hosoya_hiro@example.com
今田 勝久	imada_katsuhisa@example.com
山瀬 愛菜	yamase_aina@example.com
野呂 佑	noro_tasuku@example.com
中原 貴美子	nakahara_kimiko@example.com
田辺 育二	tanabe_ikuji@example.com
石川 聡	ishikawa_satoshi@example.com
大津 マサカズ	ootsu_masakazu@example.com
福田 明日	fukuda_meibi@example.com
柳家 勇	yanagiya_yuu@example.com
久保田 瞬	kubota_shun@example.com
菅沼 あさみ	suganuma_asami@example.com
山田 優	yamada_yuu1@example.com
庄司 遥	shouji_haruka@example.com
川井 一代	kawai_kazuyo@example.com
西野 光	nishino_hikaru@example.com
水口 結子	mizuguchi_yuuko@example.com
水崎 直人	misaki_naoto@example.com
大石 真悠子	ooishi_mayuko@example.com
島村 きみまろ	shimamura_kimimaro@example.com
寺尾 まさし	terao_masashi@example.com
浅見 そら	asami_sora@example.com
岡崎 恵子	okazaki_keiko1@example.com
鶴田 景子	tsuruta_keiko@example.com
田淵 宏行	tabuchi_hiroyuki@example.com
岩沢 まさし	iwasawa_masashi@example.com
奥 美和子	oku_miwako@example.com
向井 愛子	murai_aiko@example.com
正木 薫	masaki_kaoru@example.com
武藤 美月	mutou_miduki@example.com
河野 咲	kouno_saki@example.com
岩田 さやか	iwata_sayaka@example.com
橋爪 美幸	hashidume_miyuki@example.com
岩本 まさし	iwamoto_masashi@example.com
松浦 鉄洋	matsuura_tetsuhiro@example.com
池内 郁恵	ikeuchi_ikue@example.com
柴咲 ちえみ	shibasaki_chiemi@example.com
村山 ひとみ	murayama_hitomi@example.com
谷本 奈月	tanimoto_natsuki@example.com
武藤 基祐	mutou_kisuke@example.com
瀬尾 宏	seo_hiroshi@example.com
古屋 七世	furuya_nanase@example.com
大木 まさみ	ooki_masami@example.com
今田 勝久	imada_katsuhisa1@example.com
ともさか 雅之	tomosaka_masayuki@example.com
石井 祐一	ishii_yuuichi@example.com
浅野 さやか	asano_sayaka@example.com
哀川 高史	aikawa_takashi1@example.com
藤井 美嘉	fujii_mika@example.com
熊谷 綾女	kumagaya_ayame@example.com
今野 勇介	imano_yuusuke@example.com
山田 美月	yamada_miduki@example.com
宇野 杏	uno_ann@example.com
佐々木 信輔	sasaki_shinsuke@example.com
田辺 佑	tanabe_tasuku@example.com
橘 薫	tachibana_kaoru@example.com
竹原 圭	takehara_kei@example.com
山岸 一樹	yamagishi_kazuki@example.com
片桐 優	katagiri_yuu@example.com
立石 一樹	tachiishi_kazuki@example.com
児島 ヒロ	kojima_hiro@example.com
望月 了	mochiduki_ryou@example.com
井川 奈々	igawa_nana@example.com
土井 遥	doi_haruka@example.com
森山 英嗣	moriyama_hidetsugu@example.com
徳田 太朗	tokuta_tarou@example.com
柳原 充則	yanagihara_mitsunori@example.com
池谷 勝久	iketani_katsuhisa@example.com
本間 美紀	honma_miki@example.com
吉永 ノブヒコ	yoshinaga_nobuhiko@example.com
高松 昴	takamatsu_subaru@example.com
金井 晴臣	kanai_haruomi@example.com
浅川 未華子	asakawa_mikako@example.com
立川 友以乃	tachikawa_yuino@example.com
浜口 長利	hamaguchi_nagatoshi@example.com
伊藤 恵梨香	itou_erika@example.com
北川 祐一	kitakawa_yuuichi@example.com
沢田 光博	sawada_mitsuhiro@example.com
芳賀 栄一	haga_eiichi@example.com
堀江 茜	horie_akane@example.com
戸田 さやか	toda_sayaka@example.com
宮地 京子	miyaji_kyouko@example.com
岡本 あや子	okamoto_ayako@example.com
坂井 結子	sakai_yuuko@example.com
黄川田 右京	kikawada_ukyou@example.com
遠藤 京子	enndou_kyouko@example.com
綾瀬 雄太	ayase_yuuta@example.com
菊田 紗季	kikuta_saki@example.com
飛田 遥	hida_haruka@example.com
井川 美里	igawa_miri@example.com
矢島 さとみ	yajima_satomi@example.com
野崎 あや子	nozaki_ayako@example.com
古田 恵美	furuta_megumi@example.com
高沢 一徳	takasawa_ittoku@example.com
長瀬 獅童	nagase_shidou@example.com
笠原 輝信	kasahara_akinobu@example.com
立石 さやか	tachiishi_sayaka@example.com
大沢 麻由子	oosawa_mayuko@example.com
藤山 六郎	fujiyama_rokurou@example.com
小高 雅彦	kodaka_masahiko@example.com
大熊 正敏	ookuma_masatoshi@example.com
今 賢二	kon_kenji@example.com
吉永 妃里	yoshinaga_yuri@example.com
高山 綾	takayama_aya@example.com
高原 明	takahara_akira@example.com
神谷 将也	kamiya_masaya@example.com
磯部 真帆	isobe_maho@example.com
小田 勇	oda_yuu@example.com
畑 ヒカル	hatake_hikaru@example.com
多部 花	tabe_hana@example.com
仲村 恵子	nakamura_keiko@example.com
鈴木 さゆり	suzuki_sayuri@example.com
古谷 知史	furutani_tomofumi@example.com
丸山 直人	maruyama_naoto@example.com
浜田 勝久	hamada_katsuhisa@example.com
堀口 幸平	horiguchi_kouhei@example.com
宮野 奈央	miyano_nao1@example.com
金井 一哉	kanai_kazuya@example.com
大平 憲史	oohira_norihito@example.com
一青 勝久	hitoto_katsuhisa@example.com
高梨 美嘉	takanashi_mika@example.com
児玉 法子	kodama_noriko@example.com
長浜 愛子	nagahama_aiko@example.com
大久保 直人	ookubo_naoto@example.com
上野 将也	ueno_masaya@example.com
石原 きみまろ	ishihara_kimimaro@example.com
甲斐 勇一	kai_yuuichi@example.com
亀山 南朋	kameyama_nao@example.com
田尻 徹平	tajiri_teppei@example.com
飛田 賢二	hida_kenji@example.com
滝 メイサ	taki_meisa@example.com
白石 光	shiraishi_hikaru@example.com
石垣 みあ	ishigaki_mia@example.com
市村 しほり	ichimura_shihori@example.com
浅沼 惇	asanuma_atsushi@example.com
荒川 さとみ	arakawa_satomi@example.com
竹下 一恵	takeshita_kadue@example.com
畠山 豊	hatayama_yutaka@example.com
藤井 徹	fujii_tooru@example.com
武藤 徹	mutou_tooru@example.com
塩田 由美子	shiota_yumiko@example.com
松井 宏	matsui_hiroshi@example.com
伊藤 杏	itou_ann@example.com
有賀 美紀	ariga_miki@example.com
勝地 花	katsudi_hana@example.com
吉村 杏	yoshimura_ann@example.com
黒崎 一徳	kurosaki_ittoku@example.com
小泉 誠治	koizumi_seiji@example.com
松永 一恵	matsunaga_kadue@example.com
片桐 仁晶	katagiri_hiroaki@example.com
大森 ヒロ	oomori_hiro@example.com
片桐 満	katagiri_mitsuru@example.com
瀬戸 勝久	seto_katsuhisa@example.com
塩谷 真奈美	shioya_manami@example.com
神野 エリカ	kamino_erika@example.com
杉田 美佐子	sugita_misako@example.com
大泉 奈々	ooizumi_nana@example.com
末永 ヒロ	suenaga_hiro@example.com
新垣 優	niigaki_yuu@example.com
松永 美佳	matsunaga_mika@example.com
真矢 惇	maya_atsushi@example.com
手塚 あや子	teduka_ayako@example.com
真矢 広司	maya_kouji@example.com
下山 兼	shimoyama_ken@example.com
染谷 莉沙	someya_risa@example.com
五十嵐 右京	igarashi_ukyou@example.com
望月 花	mochiduki_hana@example.com
西村 晋也	nishimura_shinya@example.com
内藤 賢二	naitou_kenji@example.com
宮脇 美希	miyawaki_miki@example.com
松野 麻由子	matsuno_mayuko@example.com
相川 フミヤ	aikawa_fumiya@example.com
柳 ヒロ	yanagi_hiro@example.com
塚原 未來	tsukahara_mirai@example.com
小市 さゆり	koichi_sayuri@example.com
玉置 ジョージ	tamaki_george1@example.com
相田 沙知絵	aida_sachie@example.com
村井 努	murai_tsutomu@example.com
中川 一	nakagawa_hajime@example.com
宮下 璃子	miyashita_riko@example.com
竹中 翔太	takenaka_shouta@example.com
香椎 まなみ	kashii_manami@example.com
村中 千佳子	muranaka_chikako@example.com
白川 奈央	shirakawa_nao@example.com
花田 光	hanada_hikaru@example.com
沢田 愛子	sawada_aiko@example.com
児島 有海	kojima_ami@example.com
香椎 勝久	kashii_katsuhisa@example.com
新井 遥	arai_haruka@example.com
関口 有海	sekiguchi_ami@example.com
八田 メイサ	yatsuda_meisa@example.com
伊藤 未來	itou_mirai@example.com
杉田 綾女	sugita_ayame@example.com
古田 陽子	furuta_youko@example.com
三島 菊生	mishima_kikuo@example.com
梅沢 敏也	umezawa_toshiya@example.com
宮崎 獅童	miyazaki_shidou@example.com
岩永 真希	iwanaga_maki@example.com
岡山 徹平	okayama_teppei@example.com
岩沢 幸平	iwasawa_kouhei@example.com
石沢 弘也	ishizawa_hironari@example.com
北田 光洋	kitada_mitsuhiro@example.com
飛田 窈	hida_you@example.com
勝又 幸子	katsumata_sachiko@example.com
畠中 薫	hatanaka_kaoru@example.com
天野 りえ	amano_rie@example.com
福地 鉄洋	fukuchi_tetsuhiro@example.com
藤澤 あさみ	fujisawa_asami@example.com
西浦 浩介	nishiura_kousuke@example.com
野口 亜希	noguchi_aki@example.com
山口 早織	yamaguchi_saori@example.com
坂本 妃里	sakamoto_yuri@example.com
渡辺 由樹	watanabe_yuki@example.com
塩沢 遥	shiozawa_haruka@example.com
向井 克実	murai_katsumi@example.com
黒崎 光臣	kurosaki_mitsuomi@example.com
矢野 きみまろ	yano_kimimaro@example.com
加藤 有海	katou_ami@example.com
佐藤 たまき	satou_tamaki@example.com
安座間 耕司	azama_kouji1@example.com
小田島 真悠子	odajima_mayuko@example.com
今村 兼	imamura_ken@example.com
星野 真帆	hoshino_maho@example.com
北村 美月	kitamura_miduki@example.com
福原 龍吉	fukuhara_ryuukichi@example.com
大竹 ノブヒコ	ootake_nobuhiko@example.com
阪口 一恵	sakaguchi_kadue@example.com
内野 正敏	uchino_masatoshi@example.com
奥村 みゆき	okumura_miyuki@example.com
奥山 蒼甫	okuyama_sousuke@example.com
今井 勇	imai_yuu@example.com
大滝 ひとり	ootaki_hitori@example.com
江藤 淳	etou_atsushi@example.com
須藤 真悠子	sudou_mayuko@example.com
小谷 恵子	kotani_keiko@example.com
酒井 俊介	sakai_shunsuke@example.com
矢野 大	yano_masaru@example.com
大矢 美智子	ooya_michiko@example.com
渡部 優	watabe_yuu@example.com
有田 雅彦	arita_masahiko@example.com
上杉 惇	uesugi_jun@example.com
岩淵 真希	iwabuchi_maki@example.com
杉本 莉沙	sugimoto_risa@example.com
根本 茂樹	nemoto_shigeki@example.com
小西 麻由子	konishi_mayuko@example.com
岩佐 ひとみ	iwasa_hitomi@example.com
下川 恵梨香	shimokawa_erika@example.com
岩佐 真一	iwasa_shinichi@example.com
藤川 貴嶺	fujikawa_takane@example.com
高井 高史	takai_takashi@example.com
六角 夏空	rokkaku_sora@example.com
山西 璃奈子	yamanishi_rinako@example.com
山中 一	yamanaka_hajime@example.com
浅井 奈々	asai_nana@example.com
大津 夏希	ootsu_natsuki@example.com
藤川 沙耶	fujikawa_saya@example.com
上原 未來	uehara_mirai@example.com
滝川 聡	takigawa_satoshi@example.com
藤原 ひろみ	fujiwara_hiromi@example.com
塩見 健	shiomi_ken@example.com
小口 誠治	oguchi_seiji@example.com
高岡 明日	takaoka_meibi@example.com
秋山 明	akiyama_akira@example.com
相原 あや子	aihara_ayako@example.com
大島 美咲	ooshima_misaki@example.com
堤 敦	tsutsumi_atsushi@example.com
橋本 みあ	hashimoto_mia@example.com
岡山 聖陽	okayama_masaaki@example.com
畠山 寛	hatayama_hiroshi@example.com
上原 亮介	uehara_ryousuke@example.com
寺脇 晴臣	terawaki_haruomi@example.com
毛利 妃里	mouri_yuri@example.com
黒沢 竜也	kurosawa_tatsuya@example.com
大河内 洋	ookouchi_you@example.com
磯野 広司	isono_kouji@example.com
川中 朝陽	kawanaka_asahi@example.com
浅野 明日	asano_meibi@example.com
今川 陽子	imagawa_youko@example.com
正木 千佳子	masaki_chikako@example.com
上田 早紀	ueda_saki@example.com
松田 ひろ子	matsuda_hiroko@example.com
中川 慶二	nakagawa_keiji@example.com
小西 まひる	konishi_mahiru@example.com
塩谷 愛子	shiotani_aiko1@example.com
長澤 麻緒	nagasawa_mao@example.com
西岡 フミヤ	nishioka_fumiya@example.com
西川 雅之	nishikawa_masayuki@example.com
土井 華子	doi_hanako@example.com
宇田川 充則	udagawa_mitsunori@example.com
藤原 桃子	fujiwara_momoko@example.com
飯田 淳子	iida_atsuko@example.com
金森 文世	kanamori_fumiyo@example.com
若林 那奈	wakabayashi_nana@example.com
福島 れいな	fukushima_reina@example.com
秋本 隼士	akimoto_shunji@example.com
金子 俊二	kaneko_shunji@example.com
武井 あおい	takei_aoi@example.com
伊藤 克実	itou_katsumi@example.com
浦田 浩正	urata_hiromasa@example.com
水崎 華子	misaki_hanako@example.com
芳賀 賢治	haga_kenji@example.com
岸田 浩太郎	kishida_koutarou@example.com
中島 大	nakajima_masaru@example.com
野村 惇	nomura_atsushi@example.com
葛西 恵麻	kasai_ema@example.com
劇団 一恵	gekidan_kadue@example.com
島津 満	shimadu_mitsuru@example.com
早川 崇史	hayakawa_takashi@example.com
飯島 一輝	iijima_kazuki@example.com
本上 怜奈	honjo_reina@example.com
杉浦 マサカズ	sugiura_masakazu@example.com
西井 花	nishii_hana@example.com
青柳 哲平	aoyagi_teppei@example.com
今田 弘也	imada_hironari@example.com
大沢 大樹	oosawa_hiroki@example.com
矢口 圭	yaguchi_kei@example.com
北沢 未華子	kitazawa_mikako@example.com
野田 惇	noda_jun@example.com
遠藤 美里	enndou_miri@example.com
北村 剛基	kitamura_yoshiki@example.com
若杉 晴臣	wakasugi_haruomi@example.com
有田 誠治	arita_seiji@example.com
吉川 麻緒	yoshikawa_mao@example.com
和田 隼士	wada_shunji1@example.com
松山 雅彦	matsuyama_masahiko@example.com
角谷 浩太郎	kadotani_koutarou@example.com
有馬 光博	arima_mitsuhiro@example.com
大城 勤	ooshiro_tsutomu@example.com
有村 里穂	arimura_riho@example.com
玉田 丈史	tamada_takeshi@example.com
島 真吾	shima_shingo@example.com
沢田 隆博	sawada_takahiro@example.com
小池 長利	koike_nagatoshi@example.com
貫地谷 恵梨香	kanjiya_erika@example.com
森下 光博	morishita_mitsuhiro@example.com
奥寺 隼士	okudera_shunji@example.com
三橋 優	mihashi_yuu@example.com
松沢 あい	matsuzawa_ai1@example.com
藤山 剛基	fujiyama_yoshiki@example.com
山本 明	yamamoto_akira@example.com
門田 雄太	kadota_yuuta@example.com
石本 早紀	ishimoto_saki@example.com
大村 あさみ	oomura_asami@example.com
玉田 朝香	tamada_asaka@example.com
上村 賢二	uemura_kenji1@example.com
矢島 信吾	yajima_shingo@example.com
成瀬 拓郎	naruse_takurou@example.com
岩間 恵美	iwama_megumi@example.com
藤沢 恵梨香	fujisawa_erika1@example.com
長沢 翔	nagasawa_shou@example.com
二宮 慶二	ninomiya_keiji@example.com
遠山 まさし	tooyama_masashi@example.com
砂川 広之	sunakawa_hiroyuki@example.com
玉山 淳子	tamayama_atsuko@example.com
阿久津 満	akutsu_mitsuru@example.com
吉永 光博	yoshinaga_mitsuhiro1@example.com
竹村 七世	takemura_nanase@example.com
彼方 みあ	kanata_mia@example.com
細川 明	hosokawa_akira@example.com
西沢 知史	nishizawa_tomofumi@example.com
須賀 奈月	suga_natsuki@example.com
竹田 右京	takeda_ukyou@example.com
植松 愛菜	uematsu_aina@example.com
竹中 孝太郎	takenaka_koutarou@example.com
大下 一樹	ooshita_kazuki@example.com
坂本 敦	sakamoto_atsushi@example.com
今井 遥	imai_haruka@example.com
勝田 幸子	katsuda_sachiko@example.com
田尻 ジローラモ	tajiri_girolamo@example.com
瀬戸 知世	seto_chise@example.com
原田 勇介	harada_yuusuke@example.com
佐藤 右京	satou_ukyou@example.com
植木 しぼり	ueki_shibori@example.com
谷本 恵子	tanimoto_keiko@example.com
足立 友香	adachi_tomoka@example.com
竹内 博之	takeuchi_hiroyuki@example.com
二宮 佳乃	ninomiya_yoshino@example.com
向井 理紗	murai_risa@example.com
内田 竜也	uchida_tatsuya@example.com
笹川 大樹	sasagawa_hiroki@example.com
河西 ひろ子	kawanishi_hiroko@example.com
片桐 知世	katagiri_chise@example.com
渡部 璃奈子	watabe_rinako@example.com
秋山 理紗	akiyama_risa@example.com
瀬戸 樹里	seto_juri@example.com
橋本 隆	hashimoto_takashi@example.com
吉永 俊二	yoshinaga_shunji@example.com
宮島 ひろ子	miyajima_hiroko@example.com
森下 良介	morishita_ryousuke1@example.com
勝田 満	katsuda_mitsuru@example.com
前川 雅彦	maekawa_masahiko@example.com
小野 圭	ono_kei@example.com
岩下 ひろみ	iwashita_hiromi@example.com
堀越 竜也	horikoshi_tatsuya@example.com
吹石 勝久	fukiishi_katsuhisa@example.com
畑 春樹	hatake_haruki@example.com
白鳥 りえ	shiratori_rie@example.com
三好 樹里	miyoshi_juri@example.com
彼方 めぐみ	kanata_megumi@example.com
竹下 克実	takeshita_katsumi@example.com
三宅 明慶	miyake_akiyoshi@example.com
長瀬 宏行	nagase_hiroyuki@example.com
奥寺 寛	okudera_hiroshi@example.com
早美 和久	hayami_kazuhisa@example.com
武内 真悠子	takeuchi_mayuko@example.com
上条 麗奈	kamijou_rena@example.com
井本 はるか	imoto_haruka@example.com
宮川 和之	miyakawa_kazuyuki@example.com
浅利 ケンイチ	asari_kenichi@example.com
木村 恵望子	kimura_emiko@example.com
木原 由宇	kihara_yuu1@example.com
五大 丈雄	godai_takeo@example.com
杉野 瞬	sugino_shun@example.com
岩間 広司	iwama_kouji@example.com
片山 草太	katayama_souta@example.com
大川 れいな	ookawa_reina@example.com
大倉 茜	ookura_akane@example.com
大友 勇	ootomo_yuu@example.com
宇都宮 昴	utsunomiya_subaru@example.com
波多野 真一	hatano_shinichi@example.com
福岡 優	fukuoka_yuu@example.com
石渡 美智子	ishiwatari_michiko@example.com
津田 小百合	tsuda_sayuri@example.com
首藤 ケンイチ	sudou_kenichi@example.com
葛西 恵梨香	kasai_erika1@example.com
長尾 大五郎	nagao_daigorou@example.com
小川 完爾	ogawa_kanji@example.com
阪本 陽子	sakamoto_youko@example.com
長尾 はるか	nagao_haruka@example.com
品川 照生	shinagawa_teruo@example.com
池内 勝久	ikeuchi_katsuhisa@example.com
小出 さんま	koide_sanma@example.com
有賀 沙耶	ariga_saya@example.com
森山 和香	moriyama_waka@example.com
宮内 美優	miyauchi_myuu@example.com
柄本 サンタマリア	emoto_stmaria@example.com
寺島 由樹	terajima_yuki@example.com
麻生 宏行	asou_hiroyuki@example.com
早川 仁	hayakawa_jin@example.com
横田 芳正	yokota_yoshimasa@example.com
安永 恵望子	yasunaga_emiko@example.com
山崎 未華子	yamazaki_mikako@example.com
西井 サダヲ	nishii_sadawo@example.com
和泉 勇太	waizumi_yuuta@example.com
磯部 憲史	isobe_norihito@example.com
黒川 メイサ	kurokawa_meisa@example.com
矢作 美月	yahagi_miduki@example.com
大地 メイサ	oochi_meisa@example.com
前島 隼士	maejima_shunji@example.com
長瀬 樹里	nagase_juri@example.com
福山 祐基	fukuyama_yuuki@example.com
三浦 光	miura_hikaru@example.com
荒木 ひとみ	araki_hitomi@example.com
奥村 広之	okumura_hiroyuki@example.com
角田 みあ	kadota_mia@example.com
大畑 そら	oohata_sora@example.com
南部 砂羽	nannbu_sawa@example.com
玉田 隆太	tamada_ryuuta@example.com
吉永 美幸	yoshinaga_miyuki@example.com
相武 和久	aibu_kazuhisa@example.com
森川 寿明	morikawa_toshiaki@example.com
対馬 崇史	tsushima_takashi@example.com
宍戸 一輝	shishido_kazuki@example.com
矢田 晃司	yada_kouji@example.com
大内 広之	oouchi_hiroyuki@example.com
車 真帆	kuruma_maho@example.com
武内 竜也	takeuchi_tatsuya@example.com
相川 莉央	aikawa_rio@example.com
近藤 寛治	konndou_kanji@example.com
松島 和久	matsushima_kazuhisa@example.com
河合 直人	kawai_naoto@example.com
松崎 一徳	matsuzaki_ittoku@example.com
矢口 杏	yaguchi_ann@example.com
羽田 信輔	hada_shinsuke@example.com
津田 進	tsuda_susumu@example.com
布施 未來	fuse_mirai@example.com
波多野 麗奈	hatano_rena@example.com
草村 ひとみ	kusamura_hitomi@example.com
神戸 紗季	koube_saki@example.com
及川 賢治	oikawa_kenji@example.com
上杉 メイサ	uesugi_meisa@example.com
藤川 大樹	fujikawa_hiroki@example.com
金田 玲那	kaneda_rena@example.com
劇団 輝信	gekidan_akinobu@example.com
松原 めぐみ	matsubara_megumi@example.com
宮城 そら	miyagi_sora@example.com
古沢 れいな	furusawa_reina@example.com
上田 麗奈	ueda_rena@example.com
並木 沙知絵	namiki_sachie@example.com
小木 愛菜	ogi_aina@example.com
岡崎 りえ	okazaki_rie@example.com
豊田 俊二	toyota_shunji@example.com
浜本 勝久	hamamoto_katsuhisa@example.com
丸山 丈史	maruyama_takeshi@example.com
小田 なつみ	oda_natsumi@example.com
中里 新太	nakazato_arata@example.com
島 優	shima_yuu@example.com
細田 勝久	hosoda_katsuhisa@example.com
水嶋 満	mizushima_mitsuru@example.com
熊谷 浩正	kumagaya_hiromasa@example.com
椎名 一哉	shiina_kazuya@example.com
柳川 莉沙	yanagawa_risa@example.com
松尾 美希	matsuo_miki@example.com
山岡 美咲	yamaoka_misaki@example.com
水野 晃司	mizuno_kouji@example.com
横川 憲史	yokokawa_norihito@example.com
松尾 由宇	matsuo_yuu1@example.com
吉岡 博明	yoshioka_hiroaki@example.com
山田 ジョージ	yamada_george@example.com
相田 あさみ	aida_asami@example.com
川上 照生	kawakami_teruo@example.com
小林 信輔	kobayashi_shinsuke@example.com
小野田 まなみ	onoda_manami@example.com
平尾 那奈	hirao_nana@example.com
深沢 正義	fukazawa_masayoshi@example.com
木村 しぼり	kimura_shibori1@example.com
草村 鉄洋	kusamura_tetsuhiro@example.com
少路 正義	shouji_masayoshi@example.com
原口 奈央	haraguchi_nao@example.com
土井 恵子	doi_keiko@example.com
梶原 まさみ	kajiwara_masami@example.com
河本 憲史	koumoto_norihito@example.com
森岡 優	morioka_yuu@example.com
梅原 優	umehara_yuu@example.com
倉田 照生	kurata_teruo@example.com
山中 芽以	yamanaka_mei@example.com
野崎 昌代	nozaki_masayo@example.com
青山 さんま	aoyama_sanma@example.com
村木 光臣	muraki_mitsuomi@example.com
江川 瞳	egawa_hitomi@example.com
横田 那奈	yokota_nana@example.com
大森 徹平	oomori_teppei@example.com
田沢 京子	tazawa_kyouko@example.com
宮崎 菜々美	miyazaki_nanami@example.com
外山 礼子	sotoyama_reiko@example.com
岡本 ヒロ	okamoto_hiro@example.com
西沢 倫子	nishizawa_noriko1@example.com
藤沢 獅童	fujisawa_shidou@example.com
平井 奈月	hirai_natsuki@example.com
志村 まさみ	shimura_masami@example.com
乾 裕司	inui_yuuji@example.com
飯塚 ヒロ	iiduka_hiro@example.com
三宅 耕司	miyake_kouji@example.com
桑田 陽介	kuwata_yousuke@example.com
矢作 美智子	yahagi_michiko@example.com
竹中 礼子	takenaka_reiko1@example.com
福沢 龍吉	fukuzawa_ryuukichi@example.com
相沢 遥	aizawa_haruka@example.com
柴田 ケンイチ	shibata_kenichi@example.com
野中 くるみ	nonaka_kurumi@example.com
田口 浩太郎	taguchi_koutarou@example.com
山川 まさみ	yamakawa_masami@example.com
森本 みあ	morimoto_mia@example.com
小谷 慎之介	kotani_shinnosuke@example.com
六角 遥	rokkaku_haruka@example.com
出口 由宇	deguchi_yuu@example.com
藤村 雅功	fujimura_masatoshi1@example.com
坂野 美帆	itano_miho@example.com
田畑 瑠璃亜	tabata_ruria@example.com
篠田 小雁	shinoda_kogan@example.com
小谷 恵子	kotani_keiko1@example.com
黒谷 さんま	kurotani_sanma@example.com
萩原 礼子	hagiwara_reiko@example.com
久保田 高史	kubota_takashi@example.com
角谷 真吾	kadotani_shingo@example.com
恩田 亜希	onnda_aki@example.com
加藤 メイサ	katou_meisa@example.com
岡本 優	okamoto_yuu@example.com
野中 そら	nonaka_sora@example.com
板橋 小雁	itabashi_kogan@example.com
新村 はじめ	niimura_hajime@example.com
及川 光良	oikawa_teruyoshi@example.com
塩見 一輝	shiomi_kazuki@example.com
水上 里穂	mizukami_riho@example.com
畑中 杏	hatanaka_ann@example.com
津田 徹	tsuda_tooru@example.com
田島 千佳子	tajima_chikako@example.com
加藤 知世	katou_chise@example.com
宇田川 華子	udagawa_hanako@example.com
